Date,Kind,Model,Max Mode,Input (w/ Cache Write),Input (w/o Cache Write),Cache Read,Output Tokens,Total Tokens,Cost
"2025-09-26T04:43:21.953Z","Included","auto","No","6335","0","1157888","2021","1166244","0.31"
"2025-09-26T04:43:03.814Z","Errored, Not Charged","auto","No","2302","0","372480","706","375488","0.10"
"2025-09-26T04:42:29.410Z","Errored, Not Charged","auto","No","14374","0","805888","1006","821268","0.23"
"2025-09-26T04:40:49.802Z","Included","auto","No","8164","0","1120512","2374","1131050","0.30"
"2025-09-26T04:40:39.617Z","Errored, Not Charged","auto","No","2545","0","79872","550","82967","0.03"
"2025-09-26T04:40:06.835Z","Errored, Not Charged","auto","No","3863","0","235008","2219","241090","0.08"
"2025-09-26T04:39:23.471Z","Errored, Not Charged","auto","No","9539","0","521728","2992","534259","0.16"
"2025-09-26T04:37:27.145Z","Included","auto","No","7825","0","854528","3735","866088","0.25"
"2025-09-26T04:37:15.597Z","Errored, Not Charged","auto","No","60837","0","72704","181","133722","0.10"
"2025-09-26T04:34:47.994Z","Included","auto","No","176483","82229","5165312","26122","5450146","1.77"
"2025-09-26T04:33:06.824Z","Errored, Not Charged","auto","No","1049","0","173312","180","174541","0.05"
"2025-09-26T04:32:55.616Z","Errored, Not Charged","auto","No","997","0","171520","379","172896","0.05"
"2025-09-26T04:32:45.375Z","Errored, Not Charged","auto","No","78726","0","6912","50","85688","0.10"
"2025-09-26T04:31:12.573Z","Included","auto","No","170937","0","3414016","6904","3591857","1.11"
"2025-09-26T04:30:01.185Z","Included","auto","No","113277","0","2917860","5587","3036724","0.90"
"2025-09-26T04:27:27.594Z","Included","auto","No","153460","73086","489074","7056","722676","0.45"
"2025-09-26T04:22:36.911Z","Included","auto","No","2535","0","217217","2345","222097","0.07"
"2025-09-26T04:21:33.927Z","Included","auto","No","77451","85443","1031424","17240","1211558","0.56"
"2025-09-26T04:21:21.100Z","Errored, Not Charged","auto","No","3647","0","197120","796","201563","0.06"
"2025-09-26T04:20:35.131Z","Included","auto","No","2475","0","487680","1474","491629","0.13"
"2025-09-26T04:20:22.451Z","Errored, Not Charged","auto","No","90563","0","198912","160","289635","0.16"
"2025-09-26T04:19:10.561Z","Included","auto","No","14366","0","416744","671","431781","0.13"
"2025-09-26T04:17:36.790Z","Errored, Not Charged","auto","No","12565","0","989210","1170","1002945","0.27"
"2025-09-26T04:17:03.694Z","Errored, Not Charged","auto","No","3051","0","742080","609","745740","0.19"
"2025-09-26T04:16:35.286Z","Included","auto","No","8876","0","172560","357","181793","0.06"
"2025-09-26T04:16:15.265Z","Included","auto","No","74930","0","7129","468","82527","0.10"
"2025-09-26T04:15:25.020Z","Included","auto","No","3197","0","321024","1518","325739","0.09"
"2025-09-26T04:13:53.804Z","Included","auto","No","19072","0","1999872","6961","2025905","0.57"
"2025-09-26T04:12:46.946Z","Included","auto","No","6372","0","231936","4527","242835","0.09"
"2025-09-26T04:11:58.725Z","Errored, Not Charged","auto","No","33205","0","557312","5954","596471","0.22"
"2025-09-26T04:02:24.714Z","Included","auto","No","12421","0","465664","3683","481768","0.15"
"2025-09-26T03:57:06.543Z","Errored, Not Charged","auto","No","39479","0","982016","10461","1031956","0.36"
"2025-09-26T03:54:31.859Z","Included","auto","No","18695","0","198656","787","218138","0.08"
"2025-09-26T03:53:41.603Z","Included","auto","No","24041","0","291072","4012","319125","0.13"
"2025-09-26T03:53:04.634Z","Included","auto","No","37085","0","291177","1927","330189","0.13"
"2025-09-26T03:51:48.986Z","Included","auto","No","50542","6842","2368000","36678","2462062","0.88"
"2025-09-26T03:49:55.042Z","Included","auto","No","20337","0","140288","774","161399","0.07"
"2025-09-26T03:46:41.939Z","Errored, Not Charged","auto","No","214752","153451","451971","45754","865928","0.85"
"2025-09-26T03:45:19.919Z","Included","auto","No","25204","0","1108480","1994","1135678","0.32"
"2025-09-26T03:45:07.708Z","Included","auto","No","1398","0","334592","390","336380","0.09"
"2025-09-26T03:43:24.103Z","Included","auto","No","596","0","84736","90","85422","0.02"
"2025-09-26T03:42:08.899Z","Included","auto","No","27702","0","676608","1643","705953","0.21"
"2025-09-26T03:41:48.076Z","Included","auto","No","49379","0","67584","157","117120","0.08"
"2025-09-26T03:41:22.128Z","Included","auto","No","1977","0","163840","340","166157","0.05"
"2025-09-26T03:40:05.817Z","Included","auto","No","1324","0","160768","981","163073","0.05"
"2025-09-26T03:39:41.140Z","Errored, Not Charged","auto","No","3407","2056","234240","1020","240723","0.07"
"2025-09-26T03:38:03.038Z","Included","auto","No","283869","76776","2996149","21560","3378354","1.33"
"2025-09-26T03:36:25.440Z","Included","auto","No","12501","0","1162496","3170","1178167","0.33"
"2025-09-26T03:35:43.546Z","Included","auto","No","1334","0","264192","755","266281","0.07"
"2025-09-26T03:35:06.015Z","Included","auto","No","1765","0","193792","508","196065","0.05"
"2025-09-26T03:32:33.206Z","Included","auto","No","5005","0","434176","1716","440897","0.13"
"2025-09-26T03:18:40.356Z","Included","auto","No","21730","0","173264","570","195564","0.07"
"2025-09-26T03:18:08.403Z","Included","auto","No","61193","0","2681856","10252","2753301","0.81"
"2025-09-26T03:14:31.763Z","Included","auto","No","64524","0","3376440","4818","3445782","0.95"
"2025-09-26T03:01:47.510Z","Errored, Not Charged","auto","No","69673","91032","5191692","26609","5379006","1.66"
"2025-09-26T03:01:00.588Z","Errored, Not Charged","auto","No","3795","0","717676","587","722058","0.19"
"2025-09-26T02:59:55.883Z","Included","auto","No","1558","0","98690","1487","101735","0.04"
"2025-09-26T02:58:59.826Z","Included","auto","No","860","0","97831","1444","100135","0.03"
"2025-09-26T02:58:06.798Z","Included","auto","No","464","0","97368","713","98545","0.03"
"2025-09-26T02:57:16.839Z","Included","auto","No","90242","2690","103999","787","197718","0.15"
"2025-09-26T02:40:03.077Z","Included","auto","No","14263","0","1878860","3973","1897096","0.51"
"2025-09-26T02:37:26.987Z","Included","auto","No","81223","11450","422641","2555","517869","0.24"
"2025-09-26T02:37:05.543Z","Errored, Not Charged","auto","No","663","6720","242410","1100","250893","0.08"
"2025-09-26T02:35:47.421Z","Errored, Not Charged","auto","No","7181","4278","464657","1727","477843","0.14"
"2025-09-26T02:34:52.526Z","Errored, Not Charged","auto","No","3700","2042","221313","1488","228543","0.07"
"2025-09-26T02:33:39.706Z","Errored, Not Charged","auto","No","7315","1893","955664","2880","967752","0.27"
"2025-09-26T02:32:20.931Z","Included","auto","No","2035","0","254636","891","257562","0.07"
"2025-09-26T02:31:16.391Z","Included","auto","No","6114","0","657188","2153","665455","0.18"
"2025-09-26T02:30:25.567Z","Errored, Not Charged","auto","No","8320","0","464317","1803","474440","0.14"
"2025-09-26T02:29:03.068Z","Errored, Not Charged","auto","No","16642","0","223386","467","240495","0.08"
"2025-09-26T02:25:17.637Z","Included","auto","No","36359","106973","978348","17949","1139629","0.53"
"2025-09-26T02:24:47.383Z","Included","auto","No","1072","0","113055","309","114436","0.03"
"2025-09-26T02:23:49.739Z","Included","auto","No","650","0","112406","922","113978","0.03"
"2025-09-26T02:22:37.550Z","Errored, Not Charged","auto","No","501","0","110549","0","111050","0.03"
"2025-09-26T02:21:17.445Z","Included","auto","No","394","0","110156","355","110905","0.03"
"2025-09-26T02:20:42.156Z","Included","auto","No","284","0","109873","253","110410","0.03"
"2025-09-26T02:20:13.089Z","Errored, Not Charged","auto","No","33370","0","282387","743","316500","0.12"
"2025-09-26T02:19:13.548Z","Included","auto","No","3962","0","389120","1600","394682","0.11"
"2025-09-26T02:19:06.472Z","Included","auto","No","4709","0","299592","402","304703","0.08"
"2025-09-26T02:17:25.323Z","Errored, Not Charged","auto","No","19030","0","1131258","1648","1151936","0.32"
"2025-09-26T02:16:56.499Z","Errored, Not Charged","auto","No","3509","0","156332","1626","161467","0.05"
"2025-09-26T02:16:11.689Z","Errored, Not Charged","auto","No","4044","0","446542","1796","452382","0.13"
"2025-09-26T02:16:05.930Z","Errored, Not Charged","auto","No","1337","0","71528","227","73092","0.02"
"2025-09-26T02:15:04.014Z","Errored, Not Charged","auto","No","10859","0","917832","2335","931026","0.26"
"2025-09-26T02:14:23.754Z","Included","auto","No","53556","0","7128","480","61164","0.07"
"2025-09-26T02:13:22.072Z","Included","auto","No","823","0","53760","173","54756","0.02"
"2025-09-26T02:13:00.593Z","Included","auto","No","242","0","53760","455","54457","0.02"
"2025-09-26T02:12:27.718Z","Errored, Not Charged","auto","No","6813","0","406528","1947","415288","0.12"
"2025-09-26T02:09:25.032Z","Included","auto","No","58887","0","1073920","5783","1138590","0.38"
"2025-09-26T02:07:26.477Z","Included","auto","No","0","0","0","0","0","0.00"
"2025-09-26T02:06:11.052Z","Errored, Not Charged","auto","No","10155","0","1959168","972","1970295","0.51"
"2025-09-26T02:05:22.115Z","Errored, Not Charged","auto","No","1994","0","490240","531","492765","0.13"
"2025-09-26T02:01:59.606Z","Included","auto","No","98944","96","3831808","8156","3939004","1.13"
"2025-09-26T01:58:27.899Z","Included","auto","No","47791","102523","1437343","25436","1613093","0.70"
"2025-09-26T01:57:27.797Z","Errored, Not Charged","auto","No","3524","0","578415","1297","583236","0.16"
"2025-09-26T01:56:39.053Z","Errored, Not Charged","auto","No","4534","0","789049","1345","794928","0.21"
"2025-09-26T01:56:38.343Z","Aborted, Not Charged","auto","No","0","0","0","0","0","0.00"
"2025-09-26T01:55:51.152Z","Included","auto","No","2456","0","551032","817","554305","0.15"
"2025-09-26T01:54:55.369Z","Errored, Not Charged","auto","No","5588","0","956186","1562","963336","0.26"
"2025-09-26T01:54:29.569Z","Errored, Not Charged","auto","No","1576","0","206187","625","208388","0.06"
"2025-09-26T01:51:36.025Z","Errored, Not Charged","auto","No","3954","0","200989","159","205102","0.06"
"2025-09-26T01:39:00.379Z","Included","auto","No","100169","0","597405","2727","700301","0.29"
"2025-09-26T01:37:53.435Z","Included","auto","No","88717","0","7128","1703","97548","0.12"
"2025-09-25T23:54:32.820Z","Included","auto","No","87149","91101","3149544","26279","3354073","1.17"
"2025-09-25T23:52:31.419Z","Included","auto","No","7623","0","786657","874","795154","0.21"
"2025-09-25T23:43:17.344Z","Included","auto","No","67711","0","4445316","14832","4527859","1.28"
"2025-09-25T23:42:41.514Z","Included","auto","No","8260","0","287142","652","296054","0.09"
"2025-09-25T23:41:02.455Z","Errored, Not Charged","auto","No","16816","0","315221","5320","337357","0.13"
"2025-09-25T23:39:03.046Z","Errored, Not Charged","auto","No","24357","95977","11228","24366","155928","0.30"
"2025-09-25T23:38:16.054Z","Included","auto","No","1016","0","116141","181","117338","0.03"
"2025-09-25T23:37:34.035Z","Errored, Not Charged","auto","No","1093","0","231694","431","233218","0.06"
"2025-09-25T23:36:28.905Z","Errored, Not Charged","auto","No","5257","0","783469","2750","791476","0.22"
"2025-09-25T23:35:31.661Z","Included","auto","No","103088","0","442167","937","546192","0.25"
"2025-09-25T22:55:54.576Z","Included","auto","No","99574","95401","5955223","37134","6187332","1.96"
"2025-09-25T22:54:32.541Z","Included","auto","No","3250","0","1019289","947","1023486","0.26"
"2025-09-25T22:45:17.251Z","Included","auto","No","67277","0","2426169","4066","2497512","0.72"
"2025-09-25T22:35:06.822Z","Errored, Not Charged","auto","No","52014","0","2961749","10010","3023773","0.87"
"2025-09-25T22:32:32.499Z","Errored, Not Charged","auto","No","36254","0","784228","4501","824983","0.27"
"2025-09-25T22:18:30.781Z","Errored, Not Charged","auto","No","18539","103316","39291","11658","172804","0.23"
"2025-09-25T22:18:23.653Z","Included","auto","No","0","0","0","0","0","0.00"
"2025-09-25T22:16:05.754Z","Errored, Not Charged","auto","No","15418","0","1016944","1244","1033606","0.28"
"2025-09-25T22:14:18.776Z","Errored, Not Charged","auto","No","103075","0","1048855","2067","1153997","0.40"
"2025-09-25T21:46:15.061Z","Included","auto","No","29027","0","1352496","2784","1384307","0.39"
"2025-09-25T21:44:14.781Z","Errored, Not Charged","auto","No","9473","0","1229782","4437","1243692","0.35"
"2025-09-25T21:43:32.324Z","Errored, Not Charged","auto","No","14176","0","329542","1679","345397","0.11"
"2025-09-25T21:43:05.811Z","Errored, Not Charged","auto","No","9754","0","171559","1258","182571","0.06"
"2025-09-25T21:42:43.293Z","Errored, Not Charged","auto","No","1290","0","113072","924","115286","0.04"
"2025-09-25T21:42:25.952Z","Errored, Not Charged","auto","No","913","0","146801","482","148196","0.04"
"2025-09-25T21:42:21.883Z","Errored, Not Charged","auto","No","441","0","35905","96","36442","0.01"
"2025-09-25T21:42:09.837Z","Errored, Not Charged","auto","No","567","0","106708","391","107666","0.03"
"2025-09-25T21:42:04.958Z","Errored, Not Charged","auto","No","517","0","34825","146","35488","0.01"
"2025-09-25T21:41:56.477Z","Errored, Not Charged","auto","No","264","0","34562","367","35193","0.01"
"2025-09-25T21:41:06.333Z","Errored, Not Charged","auto","No","7753","0","325983","817","334553","0.10"
"2025-09-25T21:34:26.910Z","Included","auto","No","23732","100679","1242195","9097","1375703","0.52"
"2025-09-25T21:33:16.037Z","Included","auto","No","2026","0","110300","358","112684","0.03"
"2025-09-25T21:32:49.569Z","Errored, Not Charged","auto","No","1369","0","331985","222","333576","0.09"
"2025-09-25T21:32:25.718Z","Errored, Not Charged","auto","No","812","0","438252","208","439272","0.11"
"2025-09-25T21:31:02.600Z","Errored, Not Charged","auto","No","6058","0","946174","1518","953750","0.25"
"2025-09-25T21:30:20.729Z","Included","auto","No","2255","0","809913","739","812907","0.21"
"2025-09-25T21:29:18.618Z","Included","auto","No","2117","0","992582","1026","995725","0.26"
"2025-09-25T21:25:20.882Z","Included","auto","No","47287","0","1920549","2437","1970273","0.55"
"2025-09-25T21:15:12.219Z","Included","auto","No","85708","75869","3329533","13286","3504396","1.11"
"2025-09-25T21:08:58.972Z","Included","auto","No","23282","0","3264990","6457","3294729","0.88"
"2025-09-25T21:06:59.938Z","Included","auto","No","79041","0","92635","445","172121","0.12"
"2025-09-25T21:03:59.281Z","Included","auto","No","10141","0","1813248","2363","1825752","0.48"
"2025-09-25T20:33:09.436Z","Included","auto","No","3568","0","738048","940","742556","0.19"
"2025-09-25T20:31:45.346Z","Included","auto","No","5205","0","634112","2033","641350","0.18"
"2025-09-25T20:30:14.165Z","Included","auto","No","6705","0","856576","2741","866022","0.24"
"2025-09-25T20:27:53.379Z","Included","auto","No","58642","0","954112","3851","1016605","0.33"
"2025-09-25T20:16:39.917Z","Included","auto","No","3184","0","218886","976","223046","0.06"
"2025-09-25T20:15:53.523Z","Errored, Not Charged","auto","No","21474","0","332249","1041","354764","0.12"
"2025-09-25T20:14:09.356Z","Errored, Not Charged","auto","No","41087","92212","215106","4910","353315","0.25"
"2025-09-25T20:06:57.495Z","Errored, Not Charged","auto","No","19095","0","2150747","5699","2175541","0.60"
"2025-09-25T20:05:44.896Z","Errored, Not Charged","auto","No","6376","0","805413","2201","813990","0.22"
"2025-09-25T20:03:15.181Z","Errored, Not Charged","auto","No","70789","0","947087","3564","1021440","0.35"
"2025-09-25T20:03:01.349Z","Included","auto","No","0","0","0","0","0","0.00"
"2025-09-25T19:58:22.807Z","Included","auto","No","1315","0","174512","394","176221","0.05"
"2025-09-25T19:57:48.614Z","Errored, Not Charged","auto","No","21396","0","93292","373","115061","0.05"
"2025-09-25T19:57:16.171Z","Errored, Not Charged","auto","No","28980","0","50736","370","80086","0.05"
"2025-09-25T19:55:36.111Z","Included","auto","No","48907","0","814592","4268","867767","0.29"
"2025-09-25T19:50:09.502Z","Included","auto","No","0","0","0","0","0","0.00"
"2025-09-25T19:39:37.232Z","Included","auto","No","2950","0","516608","647","520205","0.14"
"2025-09-25T19:36:58.003Z","Errored, Not Charged","auto","No","2320","0","199168","954","202442","0.06"
"2025-09-25T19:36:15.654Z","Included","auto","No","1515","0","196608","578","198701","0.05"
"2025-09-25T19:35:51.129Z","Included","auto","No","0","0","0","0","0","0.00"
"2025-09-25T19:31:12.202Z","Included","auto","No","102","0","98048","90","98240","0.03"
"2025-09-25T19:30:46.093Z","Errored, Not Charged","auto","No","70818","0","25600","897","97315","0.10"
"2025-09-25T19:23:26.130Z","Included","auto","No","125780","295441","936448","28064","1385733","0.93"
"2025-09-25T19:01:12.251Z","Included","auto","No","154392","0","1839104","4998","1998494","0.68"
"2025-09-25T18:58:09.157Z","Errored, Not Charged","auto","No","81000","0","824576","1811","907387","0.32"
"2025-09-25T18:55:02.061Z","Included","auto","No","10277","0","786176","2184","798637","0.22"
"2025-09-25T18:53:14.668Z","Errored, Not Charged","auto","No","7956","0","1385472","2849","1396277","0.37"
"2025-09-25T18:52:30.073Z","Included","auto","No","4615","0","705024","1414","711053","0.19"
"2025-09-25T18:42:45.430Z","Included","auto","No","4965","0","580352","1268","586585","0.16"
"2025-09-25T18:41:18.146Z","Errored, Not Charged","auto","No","2698","0","181248","4507","188453","0.08"
"2025-09-25T18:41:06.820Z","Errored, Not Charged","auto","No","21282","0","69120","67","90469","0.04"
"2025-09-25T18:35:15.424Z","Errored, Not Charged","auto","No","63949","0","2538752","9901","2612602","0.77"
"2025-09-25T18:34:37.627Z","Included","auto","No","22983","0","198656","426","222065","0.08"
"2025-09-25T18:34:09.234Z","Included","auto","No","73510","0","25600","459","99569","0.10"
"2025-09-25T18:30:57.211Z","Errored, Not Charged","auto","No","74236","0","23808","873","98917","0.10"
"2025-09-25T18:22:47.739Z","Errored, Not Charged","auto","No","80797","0","2809856","8764","2899417","0.86"
"2025-09-25T18:22:27.754Z","Errored, Not Charged","auto","No","1648","0","456192","354","458194","0.12"
"2025-09-25T18:21:50.577Z","Errored, Not Charged","auto","No","6997","0","781312","752","789061","0.21"
"2025-09-25T18:16:13.099Z","Errored, Not Charged","auto","No","226119","0","1588992","2607","1817718","0.70"
"2025-09-25T18:10:16.484Z","Included","auto","No","57416","0","2848256","13092","2918764","0.86"
"2025-09-25T18:10:09.526Z","Errored, Not Charged","auto","No","238","0","62720","137","63095","0.02"
"2025-09-25T18:07:46.876Z","Errored, Not Charged","auto","No","17158","0","1005568","4184","1026910","0.30"
"2025-09-25T18:06:22.736Z","Included","auto","No","63906","0","1291520","4522","1359948","0.43"
"2025-09-25T18:05:37.031Z","Included","auto","No","1796","657","192768","1617","196838","0.06"
"2025-09-25T18:05:32.137Z","Errored, Not Charged","auto","No","534","0","45824","57","46415","0.01"
"2025-09-25T18:04:56.025Z","Included","auto","No","39118","0","6912","93","46123","0.05"
"2025-09-25T16:31:56.021Z","Errored, Not Charged","auto","No","150403","134858","1331456","41597","1658314","0.94"
"2025-09-25T16:29:04.688Z","Included","auto","No","41878","0","1785088","5167","1832133","0.53"
"2025-09-25T16:26:43.262Z","Included","auto","No","2833","0","214272","943","218048","0.06"
"2025-09-25T16:23:58.254Z","Included","auto","No","14150","1102","1052672","4629","1072553","0.31"
"2025-09-25T16:19:59.633Z","Included","auto","No","2752","0","296704","866","300322","0.08"
"2025-09-25T16:19:00.505Z","Errored, Not Charged","auto","No","7081","670","611072","2583","621406","0.18"
"2025-09-25T16:18:09.165Z","Included","auto","No","891","0","210176","179","211246","0.05"
"2025-09-25T16:17:48.889Z","Errored, Not Charged","auto","No","472","0","104192","100","104764","0.03"
"2025-09-25T16:17:29.836Z","Included","auto","No","860","0","103168","99","104127","0.03"
"2025-09-25T16:15:55.508Z","Included","auto","No","10552","0","872448","1610","884610","0.24"
"2025-09-25T16:14:22.954Z","Included","auto","No","1497","0","50176","145","51818","0.02"
"2025-09-25T16:12:30.756Z","Errored, Not Charged","auto","No","26388","85605","23808","16239","152040","0.24"
"2025-09-25T15:46:25.299Z","Included","auto","No","4445","0","218624","340","223409","0.06"
"2025-09-25T15:45:40.735Z","Included","auto","No","46548","0","6912","165","53625","0.06"
"2025-09-25T15:45:32.171Z","Included","auto","No","0","0","0","0","0","0.00"
"2025-09-25T09:46:57.886Z","Included","auto","No","10600","0","1167872","3470","1181942","0.33"
"2025-09-25T09:46:19.109Z","Errored, Not Charged","auto","No","29219","0","417280","1833","448332","0.15"
"2025-09-25T09:43:44.610Z","Included","auto","No","10020","0","1126144","1714","1137878","0.30"
"2025-09-25T09:43:24.021Z","Errored, Not Charged","auto","No","76001","0","88320","213","164534","0.12"
"2025-09-25T08:42:45.170Z","Included","auto","No","10918","0","915712","3834","930464","0.27"
"2025-09-25T08:42:06.011Z","Errored, Not Charged","auto","No","5258","0","492544","1161","498963","0.14"
"2025-09-25T08:40:54.416Z","Errored, Not Charged","auto","No","8646","0","582400","2222","593268","0.17"
"2025-09-25T08:40:27.369Z","Included","auto","No","2792","0","182784","529","186105","0.05"
"2025-09-25T08:40:07.946Z","Errored, Not Charged","auto","No","502","1110","59136","581","61329","0.02"
"2025-09-25T08:39:31.983Z","Included","auto","No","52554","0","64000","784","117338","0.09"
"2025-09-25T08:04:20.521Z","Included","auto","No","2124","0","223488","463","226075","0.06"
"2025-09-25T08:01:36.620Z","Errored, Not Charged","auto","No","29091","0","265984","1704","296779","0.11"
"2025-09-25T08:01:02.166Z","Included","auto","No","4332","0","114176","405","118913","0.04"
"2025-09-25T08:00:05.679Z","Included","auto","No","6567","0","227840","541","234948","0.07"
"2025-09-25T07:58:43.847Z","Errored, Not Charged","auto","No","3021","0","674304","1167","678492","0.18"
"2025-09-25T07:58:10.915Z","Included","auto","No","87895","0","245504","303","333702","0.17"
"2025-09-25T07:48:35.316Z","Included","auto","No","2006","0","50688","92","52786","0.02"
"2025-09-25T07:46:47.514Z","Errored, Not Charged","auto","No","21407","113660","29440","19230","183737","0.29"
"2025-09-25T07:46:08.108Z","Included","auto","No","77255","0","44800","364","122419","0.11"
"2025-09-25T07:40:14.571Z","Included","auto","No","62118","0","1806848","4234","1873200","0.55"
"2025-09-25T07:38:22.402Z","Errored, Not Charged","auto","No","33114","72468","258304","15828","379714","0.29"
"2025-09-25T07:37:32.472Z","Errored, Not Charged","auto","No","4803","0","446720","986","452509","0.12"
"2025-09-25T07:29:32.930Z","Included","auto","No","2626","0","150272","659","153557","0.04"
"2025-09-25T07:28:22.942Z","Included","auto","No","1575","0","181504","461","183540","0.05"
"2025-09-25T07:27:41.784Z","Included","auto","No","2879","0","205824","399","209102","0.06"
"2025-09-25T07:27:14.300Z","Included","auto","No","1638","0","198656","617","200911","0.06"
"2025-09-25T07:26:30.285Z","Errored, Not Charged","auto","No","8616","0","456960","1411","466987","0.13"
"2025-09-25T07:21:45.667Z","Included","auto","No","1683","0","438016","618","440317","0.12"
"2025-09-25T07:21:32.733Z","Included","auto","No","651","0","108544","190","109385","0.03"
"2025-09-25T07:21:07.925Z","Included","auto","No","656","0","108032","366","109054","0.03"
"2025-09-25T07:20:19.829Z","Included","auto","No","2201","0","105984","345","108530","0.03"
"2025-09-25T07:19:48.329Z","Errored, Not Charged","auto","No","916","0","105728","616","107260","0.03"
"2025-09-25T07:17:45.775Z","Errored, Not Charged","auto","No","83133","0","957440","2699","1043272","0.36"
"2025-09-25T07:16:13.057Z","Included","auto","No","21533","0","4346880","5360","4373773","1.15"
"2025-09-25T07:10:18.691Z","Included","auto","No","11809","0","1051648","7624","1071081","0.32"
"2025-09-25T07:01:35.678Z","Included","auto","No","5804","0","468480","1446","475730","0.13"
"2025-09-25T07:01:30.636Z","Errored, Not Charged","auto","No","16562","0","62720","151","79433","0.04"
"2025-09-25T07:00:37.843Z","Included","auto","No","4362","0","563712","840","568914","0.15"
"2025-09-25T06:59:32.383Z","Included","auto","No","11118","0","68352","326","79796","0.03"
"2025-09-25T06:52:27.766Z","Included","auto","No","28358","0","1986048","11574","2025980","0.60"
"2025-09-25T06:51:36.256Z","Included","auto","No","12320","0","97536","606","110462","0.04"
"2025-09-25T06:49:40.828Z","Errored, Not Charged","auto","No","46580","100522","537344","15300","699746","0.41"
"2025-09-25T06:47:37.737Z","Included","auto","No","3863","9044","959744","2306","974957","0.27"
"2025-09-25T06:45:49.786Z","Included","auto","No","1474","0","116992","1179","119645","0.04"
"2025-09-25T06:44:54.553Z","Included","auto","No","925","0","116224","1200","118349","0.04"
"2025-09-25T06:43:38.901Z","Included","auto","No","1051","0","115200","786","117037","0.03"
"2025-09-25T06:42:37.195Z","Included","auto","No","269","0","114944","882","116095","0.03"
"2025-09-25T06:41:08.085Z","Errored, Not Charged","auto","No","15065","0","517888","3849","536802","0.17"
"2025-09-25T06:38:37.282Z","Included","auto","No","1035","0","75776","533","77344","0.02"
"2025-09-25T06:38:29.243Z","Included","auto","No","90677","54079","412672","13503","570931","0.37"
"2025-09-25T06:37:37.692Z","Included","auto","No","3598","0","254208","901","258707","0.07"
"2025-09-25T06:36:57.295Z","Included","auto","No","4964","0","203264","676","208904","0.06"
"2025-09-25T06:36:54.516Z","Included","auto","No","0","0","0","0","0","0.00"
"2025-09-25T06:36:39.765Z","Included","auto","No","3818","0","226304","478","230600","0.06"
"2025-09-25T06:36:22.785Z","Errored, Not Charged","auto","No","7288","0","139776","458","147522","0.05"
"2025-09-25T06:32:11.549Z","Included","auto","No","21837","0","3379200","7114","3408151","0.91"
"2025-09-25T06:31:35.545Z","Errored, Not Charged","auto","No","14945","0","517888","915","533748","0.15"
"2025-09-25T06:31:24.954Z","Included","auto","No","10982","0","1735168","4476","1750626","0.47"
"2025-09-25T06:30:26.322Z","Errored, Not Charged","auto","No","2494","0","454144","572","457210","0.12"
"2025-09-25T06:29:49.977Z","Errored, Not Charged","auto","No","6952","0","607488","1233","615673","0.17"
"2025-09-25T06:28:09.584Z","Included","auto","No","7357","0","641024","2826","651207","0.19"
"2025-09-25T06:25:33.261Z","Included","auto","No","55538","0","1199872","3561","1258971","0.39"
"2025-09-25T05:54:46.465Z","Included","auto","No","45548","86182","515840","16039","663609","0.39"
"2025-09-25T05:50:35.109Z","Included","auto","No","117998","0","2070016","3314","2191328","0.68"
"2025-09-25T05:49:05.815Z","Errored, Not Charged","auto","No","17263","0","946688","1536","965487","0.27"
"2025-09-25T05:43:42.367Z","Included","auto","No","54336","0","37632","81","92049","0.08"
"2025-09-25T05:39:40.854Z","Included","auto","No","50558","85063","1442048","31073","1608742","0.72"
"2025-09-25T05:36:44.293Z","Included","auto","No","8422","0","1032192","1928","1042542","0.28"
"2025-09-25T05:35:47.935Z","Included","auto","No","1845","0","333056","455","335356","0.09"
"2025-09-25T05:35:40.869Z","Errored, Not Charged","auto","No","702","0","109824","249","110775","0.03"
"2025-09-25T05:34:54.119Z","Errored, Not Charged","auto","No","1294","0","217856","972","220122","0.06"
"2025-09-25T05:34:08.765Z","Included","auto","No","4850","0","318208","362","323420","0.09"
"2025-09-25T05:32:57.238Z","Included","auto","No","417","0","104704","396","105517","0.03"
"2025-09-25T05:32:46.000Z","Errored, Not Charged","auto","No","595","0","209152","98","209845","0.05"
"2025-09-25T05:32:38.888Z","Errored, Not Charged","auto","No","1277","0","103424","37","104738","0.03"
"2025-09-25T05:32:25.929Z","Errored, Not Charged","auto","No","5215","0","201216","836","207267","0.06"
"2025-09-25T05:31:15.370Z","Included","auto","No","80324","0","1000704","2962","1083990","0.37"
"2025-09-25T05:22:55.202Z","Included","auto","No","35483","0","3634688","8041","3678212","1.00"
"2025-09-25T05:21:04.270Z","Errored, Not Charged","auto","No","19110","0","921600","4267","944977","0.28"
"2025-09-25T05:20:54.771Z","Errored, Not Charged","auto","No","7751","0","74496","135","82382","0.03"
"2025-09-25T05:20:05.523Z","Errored, Not Charged","auto","No","8313","104732","28672","9730","151447","0.21"
"2025-09-25T05:15:34.449Z","Included","auto","No","2584","0","1197056","919","1200559","0.31"
"2025-09-25T05:15:28.067Z","Errored, Not Charged","auto","No","7916","0","111360","76","119352","0.04"
"2025-09-25T05:07:15.244Z","Errored, Not Charged","auto","No","0","0","0","0","0","0.00"
"2025-09-25T05:04:11.169Z","Included","auto","No","10762","0","2289408","3302","2303472","0.61"
"2025-09-25T05:00:14.507Z","Errored, Not Charged","auto","No","49404","0","4185088","4477","4238969","1.13"
"2025-09-25T04:56:53.598Z","Included","auto","No","42176","92950","430336","21661","587123","0.41"
"2025-09-25T04:56:01.244Z","Included","auto","No","46450","0","980480","1484","1028414","0.31"
"2025-09-25T04:55:16.786Z","Included","auto","No","372","0","89174","318","89864","0.02"
"2025-09-25T04:54:27.653Z","Included","auto","No","82124","0","793754","1218","877096","0.31"
"2025-09-25T04:52:47.701Z","Included","auto","No","28746","1263","986368","1560","1017937","0.29"
"2025-09-25T04:52:28.693Z","Included","auto","No","3016","0","162048","1141","166205","0.05"
"2025-09-25T04:52:04.427Z","Errored, Not Charged","auto","No","3628","0","319232","430","323290","0.09"
"2025-09-25T04:51:13.201Z","Errored, Not Charged","auto","No","5252","0","526592","1286","533130","0.15"
"2025-09-25T04:51:04.500Z","Errored, Not Charged","auto","No","2100","0","217088","260","219448","0.06"
"2025-09-25T04:51:00.955Z","Errored, Not Charged","auto","No","3097","0","68864","85","72046","0.02"
"2025-09-25T04:47:56.602Z","Errored, Not Charged","auto","No","68146","83780","1027584","22213","1201723","0.58"
"2025-09-25T04:47:18.203Z","Included","auto","No","3814","0","318720","1367","323901","0.09"
"2025-09-25T04:38:15.756Z","Included","auto","No","16160","0","69132","424","85716","0.04"
"2025-09-25T04:31:51.491Z","Included","auto","No","16199","0","3004288","5167","3025654","0.80"
"2025-09-25T04:31:36.998Z","Errored, Not Charged","auto","No","2882","0","133156","705","136743","0.04"
"2025-09-25T04:30:59.996Z","Included","auto","No","2815","0","196463","963","200241","0.06"
"2025-09-25T04:30:33.978Z","Errored, Not Charged","auto","No","2201","0","252402","1164","255767","0.07"
"2025-09-25T04:30:16.031Z","Included","auto","No","593","0","123430","466","124489","0.03"
"2025-09-25T04:29:51.042Z","Included","auto","No","981","0","182975","340","184296","0.05"
"2025-09-25T04:29:12.554Z","Included","auto","No","1022","0","179573","516","181111","0.05"
"2025-09-25T04:28:27.497Z","Included","auto","No","10251","0","168002","469","178722","0.06"
"2025-09-25T04:27:57.328Z","Included","auto","No","93","0","58854","96","59043","0.02"
"2025-09-25T04:27:38.367Z","Errored, Not Charged","auto","No","1747","0","346162","577","348486","0.09"
"2025-09-25T04:26:51.661Z","Errored, Not Charged","auto","No","8439","0","649699","1061","659199","0.18"
"2025-09-25T04:25:23.552Z","Errored, Not Charged","auto","No","23567","96058","145048","18078","282751","0.29"
"2025-09-25T04:24:42.885Z","Included","auto","No","112383","0","7062","769","120214","0.15"
"2025-09-25T04:21:54.984Z","Included","auto","No","1523","0","104448","107","106078","0.03"
"2025-09-25T04:03:27.134Z","Included","auto","No","2303","0","103424","111","105838","0.03"
"2025-09-25T04:03:02.936Z","Errored, Not Charged","auto","No","2170","0","615936","823","618929","0.16"
"2025-09-25T03:54:42.622Z","Included","auto","No","3058","0","705792","819","709669","0.19"
"2025-09-25T03:54:19.898Z","Errored, Not Charged","auto","No","10959","0","220672","1223","232854","0.08"
"2025-09-25T03:52:41.662Z","Included","auto","No","46601","0","3177728","5767","3230096","0.89"
"2025-09-25T03:52:37.330Z","Errored, Not Charged","auto","No","0","0","0","0","0","0.00"
"2025-09-25T03:50:30.486Z","Included","auto","No","37083","0","422656","1233","460972","0.16"
"2025-09-25T03:49:24.526Z","Included","auto","No","109702","0","2051072","5466","2166240","0.68"
"2025-09-25T02:51:04.916Z","Included","auto","No","31472","96199","738816","18585","885072","0.46"
"2025-09-25T02:41:30.963Z","Included","auto","No","9934","0","677120","2331","689385","0.20"
"2025-09-25T02:39:56.683Z","Included","auto","No","20084","0","775424","926","796434","0.22"
"2025-09-25T02:39:17.316Z","Included","auto","No","639","0","91136","135","91910","0.02"
"2025-09-25T02:38:53.436Z","Included","auto","No","10123","0","81152","413","91688","0.04"
"2025-09-25T02:01:39.267Z","Included","auto","No","392","0","80896","81","81369","0.02"
"2025-09-25T02:01:19.384Z","Included","auto","No","188","0","80896","101","81185","0.02"
"2025-09-25T01:53:37.689Z","Included","auto","No","79205","0","525824","625","605654","0.23"
"2025-09-25T01:52:02.533Z","Errored, Not Charged","auto","No","616","0","78592","99","79307","0.02"
"2025-09-25T01:50:04.836Z","Included","auto","No","173","0","78592","112","78877","0.02"
"2025-09-25T01:40:21.920Z","Included","auto","No","4868","0","148480","106","153454","0.04"
"2025-09-25T01:37:59.681Z","Included","auto","No","14049","0","1324288","2298","1340635","0.36"
"2025-09-25T01:37:49.805Z","Included","auto","No","1256","0","61440","406","63102","0.02"
"2025-09-25T01:37:35.712Z","Errored, Not Charged","auto","No","1419","0","182272","814","184505","0.05"
"2025-09-25T01:36:24.385Z","Included","auto","No","20863","0","595200","2007","618070","0.19"
"2025-09-25T01:31:14.686Z","Included","auto","No","7003","0","392780","266","400049","0.11"
"2025-09-25T01:28:29.092Z","Included","auto","No","7390","0","765717","4903","778010","0.23"
"2025-09-25T01:28:05.358Z","Errored, Not Charged","auto","No","939","0","91062","1112","93113","0.03"
"2025-09-25T01:24:39.472Z","Included","auto","No","2457","3414","357422","2588","365881","0.11"
"2025-09-25T01:23:59.544Z","Included","auto","No","2822","0","348080","1789","352691","0.10"
"2025-09-25T01:23:15.228Z","Errored, Not Charged","auto","No","6022","0","79905","333","86260","0.03"
"2025-09-25T01:21:59.713Z","Errored, Not Charged","auto","No","153447","0","689116","1361","843924","0.37"
"2025-09-25T00:59:04.769Z","Included","auto","No","18416","101374","359168","14468","493426","0.33"
"2025-09-25T00:57:47.145Z","Included","auto","No","113921","0","6912","427","121260","0.15"
"2025-09-25T00:09:34.305Z","Included","auto","No","36271","0","2011489","3269","2051029","0.57"
"2025-09-25T00:08:49.649Z","Errored, Not Charged","auto","No","98977","0","32662","143","131782","0.13"
"2025-09-25T00:06:35.648Z","Included","auto","No","7671","0","90880","98","98649","0.03"
"2025-09-24T23:44:29.298Z","Included","auto","No","8819","0","1505024","2432","1516275","0.40"
"2025-09-24T23:44:05.509Z","Errored, Not Charged","auto","No","3083","0","713216","757","717056","0.19"
"2025-09-24T23:28:49.274Z","Included","auto","No","83031","0","1192192","1567","1276790","0.41"
"2025-09-24T23:25:50.855Z","Included","auto","No","97797","0","230953","381","329131","0.18"
"2025-09-24T22:03:05.604Z","Included","auto","No","152881","45885","3459072","16198","3674036","1.21"
"2025-09-24T22:01:15.433Z","Included","auto","No","58532","0","3520237","3722","3582491","0.98"
"2025-09-24T22:01:00.141Z","Errored, Not Charged","auto","No","0","0","0","0","0","0.00"
"2025-09-24T21:57:19.745Z","Included","auto","No","73414","0","1987840","2730","2063984","0.61"
"2025-09-24T21:43:28.902Z","Included","auto","No","61371","0","5491712","9539","5562622","1.51"
"2025-09-24T21:40:46.449Z","Included","auto","No","24310","0","2007040","1958","2033308","0.54"
"2025-09-24T21:34:53.257Z","Errored, Not Charged","auto","No","147164","0","1750528","4144","1901836","0.65"
"2025-09-24T21:32:35.624Z","Included","auto","No","190168","0","1532545","2503","1725216","0.64"
"2025-09-24T21:31:50.818Z","Included","auto","No","52399","102467","474112","11569","640547","0.38"
"2025-09-24T21:31:40.059Z","Included","auto","No","0","0","0","0","0","0.00"
"2025-09-24T21:27:40.171Z","Errored, Not Charged","auto","No","65950","0","1508608","5199","1579757","0.49"
"2025-09-24T21:15:21.410Z","Errored, Not Charged","auto","No","71885","82520","7161600","22454","7338459","2.12"
"2025-09-24T21:14:51.996Z","Included","auto","No","0","0","0","0","0","0.00"
"2025-09-24T21:14:46.386Z","Errored, Not Charged","auto","No","0","0","0","0","0","0.00"
"2025-09-24T21:13:49.261Z","Errored, Not Charged","auto","No","5994","0","654336","1101","661431","0.18"
"2025-09-24T21:05:34.175Z","Included","auto","No","37689","95517","2068577","7934","2209717","0.73"
"2025-09-24T21:05:04.738Z","Included","auto","No","1135","0","339289","472","340896","0.09"
"2025-09-24T21:04:13.833Z","Included","auto","No","1275","0","671414","598","673287","0.17"
"2025-09-24T21:03:50.481Z","Errored, Not Charged","auto","No","922","0","331640","369","332931","0.09"
"2025-09-24T21:02:50.193Z","Included","auto","No","2275","0","1089015","1049","1092339","0.28"
"2025-09-24T21:02:49.834Z","Aborted, Not Charged","auto","No","0","0","0","0","0","0.00"
"2025-09-24T21:00:58.011Z","Included","auto","No","83177","0","546048","847","630072","0.25"
"2025-09-24T20:59:46.307Z","Errored, Not Charged","auto","No","100620","0","923061","999","1024680","0.36"
"2025-09-24T20:40:49.508Z","Included","auto","No","93392","0","107396","95","200883","0.14"
"2025-09-24T20:40:00.865Z","Included","auto","No","2495","0","584704","1264","588463","0.16"
"2025-09-24T20:39:29.759Z","Included","auto","No","109912","0","123136","232","233280","0.17"
"2025-09-24T18:54:51.943Z","Included","auto","No","94451","0","1151488","2485","1248424","0.42"
"2025-09-24T18:54:04.526Z","Included","auto","No","605","0","102400","355","103360","0.03"
"2025-09-24T18:53:41.902Z","Included","auto","No","3176","0","303616","756","307548","0.08"
"2025-09-24T18:30:28.100Z","Included","auto","No","6955","0","1263616","1984","1272555","0.34"
"2025-09-24T18:18:40.372Z","Included","auto","No","69621","0","814848","1592","886061","0.30"
"2025-09-24T18:09:05.708Z","Included","auto","No","8876","0","737024","1336","747236","0.20"
"2025-09-24T18:07:09.284Z","Included","auto","No","6935","0","436224","4937","448096","0.15"
"2025-09-24T18:06:48.190Z","Errored, Not Charged","auto","No","671","0","84736","1288","86695","0.03"
"2025-09-24T18:04:07.394Z","Included","auto","No","10920","0","1756928","2989","1770837","0.47"
"2025-09-24T18:01:02.478Z","Included","auto","No","11095","0","1070336","3113","1084544","0.30"
"2025-09-24T18:00:07.238Z","Included","auto","No","10088","0","749056","2296","761440","0.21"
"2025-09-24T17:59:42.320Z","Included","auto","No","7553","0","51456","969","59978","0.03"
"2025-09-24T17:58:25.800Z","Included","auto","No","6667","0","515840","751","523258","0.14"
"2025-09-24T17:58:06.305Z","Errored, Not Charged","auto","No","3193","0","310272","691","314156","0.09"
"2025-09-24T17:55:29.776Z","Errored, Not Charged","auto","No","30071","91328","857856","13277","992532","0.45"
"2025-09-24T17:47:54.069Z","Errored, Not Charged","auto","No","115919","0","1148416","1796","1266131","0.44"
"2025-09-24T17:39:09.134Z","Included","auto","No","7728","0","2068224","1810","2077762","0.54"
"2025-09-24T17:31:52.528Z","Included","auto","No","1429","0","346112","235","347776","0.09"
"2025-09-24T17:27:18.206Z","Included","auto","No","6389","0","108800","327","115516","0.04"
"2025-09-24T17:26:49.758Z","Errored, Not Charged","auto","No","3974","0","104960","2761","111695","0.05"
"2025-09-24T17:23:44.939Z","Included","auto","No","49937","0","1838336","4757","1893030","0.55"
"2025-09-24T17:18:13.795Z","Included","auto","No","88706","0","678656","668","768030","0.28"
"2025-09-24T17:14:30.718Z","Included","auto","No","15333","0","1917440","2614","1935387","0.51"
"2025-09-24T17:14:30.471Z","Included","auto","No","9590","0","950272","1814","961676","0.26"
"2025-09-24T17:13:23.457Z","Errored, Not Charged","auto","No","33647","0","269312","5265","308224","0.14"
"2025-09-24T17:11:15.134Z","Included","auto","No","4628","0","514816","2316","521760","0.15"
"2025-09-24T17:09:34.513Z","Included","auto","No","9426","0","238848","2548","250822","0.09"
"2025-09-24T17:04:59.534Z","Included","auto","No","31505","628","374272","12555","418960","0.21"
"2025-09-24T17:00:39.195Z","Included","auto","No","73255","0","2679296","4781","2757332","0.79"
"2025-09-24T16:59:38.200Z","Included","auto","No","92982","0","303330","1539","397851","0.20"
"2025-09-24T16:51:14.747Z","Included","auto","No","69297","329941","6912","20802","426952","0.63"
"2025-09-24T16:50:03.542Z","Included","auto","No","5378","0","668412","1279","675069","0.18"
"2025-09-24T16:47:38.425Z","Included","auto","No","9622","0","1295654","1557","1306833","0.35"
"2025-09-24T16:46:48.710Z","Included","auto","No","45449","0","561611","1195","608255","0.20"
"2025-09-24T16:40:32.460Z","Included","auto","No","21455","0","788840","959","811254","0.23"
"2025-09-24T16:34:27.212Z","Included","auto","No","9067","0","1052544","1815","1063426","0.29"
"2025-09-24T16:30:18.297Z","Errored, Not Charged","auto","No","64698","0","1565343","4165","1634206","0.50"
"2025-09-24T16:29:50.234Z","Errored, Not Charged","auto","No","0","0","0","0","0","0.00"
"2025-09-24T16:25:50.058Z","Errored, Not Charged","auto","No","40581","0","1972928","4202","2017711","0.57"
"2025-09-24T16:24:20.774Z","Errored, Not Charged","auto","No","1490","0","338164","488","340142","0.09"
"2025-09-24T16:24:09.998Z","Errored, Not Charged","auto","No","40550","0","92545","306","133401","0.08"
"2025-09-24T16:20:39.045Z","Included","auto","No","2554","0","320512","1510","324576","0.09"
"2025-09-24T16:19:28.326Z","Included","auto","No","569","0","105728","575","106872","0.03"
"2025-09-24T16:18:25.793Z","Included","auto","No","14846","0","1291520","1609","1307975","0.35"
"2025-09-24T16:17:07.953Z","Included","auto","No","22746","0","141824","592","165162","0.07"
"2025-09-24T16:15:43.846Z","Included","auto","No","26079","0","391168","1069","418316","0.14"
"2025-09-24T16:15:03.153Z","Included","auto","No","2106","0","43520","790","46416","0.02"
"2025-09-24T16:05:08.790Z","Included","auto","No","20443","104227","807168","16570","948408","0.46"
"2025-09-24T16:04:09.687Z","Included","auto","No","419","0","119552","359","120330","0.03"
"2025-09-24T16:02:19.078Z","Included","auto","No","976","0","237824","478","239278","0.06"
"2025-09-24T16:01:52.462Z","Included","auto","No","284","0","118528","308","119120","0.03"
"2025-09-24T16:01:49.860Z","Errored, Not Charged","auto","No","0","0","0","0","0","0.00"
"2025-09-24T16:00:54.920Z","Included","auto","No","9097","0","921344","1483","931924","0.25"
"2025-09-24T15:59:58.573Z","Errored, Not Charged","auto","No","30568","0","1044224","2439","1077231","0.31"
"2025-09-24T15:55:25.606Z","Included","auto","No","20807","0","1204736","1450","1226993","0.34"
"2025-09-24T15:55:12.185Z","Errored, Not Charged","auto","No","33760","0","129024","181","162965","0.08"
"2025-09-24T15:39:19.658Z","Errored, Not Charged","auto","No","97796","0","1527296","2324","1627416","0.52"
"2025-09-24T15:31:56.228Z","Errored, Not Charged","auto","No","70093","0","301056","395","371544","0.17"
"2025-09-24T15:31:12.075Z","Included","auto","No","7896","0","270592","1078","279566","0.08"
"2025-09-24T15:29:04.753Z","Included","auto","No","65251","0","2151424","2999","2219674","0.64"
"2025-09-24T15:28:06.238Z","Errored, Not Charged","auto","No","63555","0","1017600","1343","1082498","0.34"
"2025-09-24T15:20:12.760Z","Included","auto","No","73728","107649","1983232","21457","2186066","0.85"
"2025-09-24T14:22:18.539Z","Included","auto","No","0","3248","428928","1468","433644","0.12"
"2025-09-24T14:21:56.752Z","Errored, Not Charged","auto","No","0","0","0","0","0","0.00"
"2025-09-24T14:20:19.139Z","Included","auto","No","0","77149","6400","71","83620","0.10"
"2025-09-24T13:59:57.308Z","Included","auto","No","0","8893","655872","1880","666645","0.19"
"2025-09-24T13:59:15.320Z","Errored, Not Charged","auto","No","0","0","0","0","0","0.00"
"2025-09-24T13:58:43.830Z","Errored, Not Charged","auto","No","0","0","0","0","0","0.00"
"2025-09-24T13:57:03.165Z","Included","auto","No","0","334","53248","893","54475","0.02"
"2025-09-24T13:56:48.152Z","Errored, Not Charged","auto","No","0","0","0","0","0","0.00"
"2025-09-24T13:56:02.018Z","Included","auto","No","0","46579","6400","534","53513","0.06"
"2025-09-24T07:52:48.537Z","Included","auto","No","37716","0","891136","3394","932246","0.29"
"2025-09-24T07:52:30.170Z","Included","auto","No","501","0","112896","369","113766","0.03"
"2025-09-24T07:51:58.557Z","Included","auto","No","3051","0","557312","704","561067","0.15"
"2025-09-24T07:51:28.793Z","Included","auto","No","3149","0","654080","845","658074","0.17"
"2025-09-24T07:50:16.001Z","Included","auto","No","18730","0","89088","362","108180","0.05"
"2025-09-24T07:49:42.560Z","Included","auto","No","17790","0","267264","432","285486","0.09"
"2025-09-24T07:49:04.634Z","Errored, Not Charged","auto","No","46719","0","219904","211","266834","0.11"
"2025-09-24T07:43:52.111Z","Included","auto","No","46011","739","922624","3069","972443","0.31"
"2025-09-24T07:43:09.769Z","Included","auto","No","15618","84244","27136","7105","134103","0.17"
"2025-09-24T07:42:02.338Z","Errored, Not Charged","auto","No","8246","868","1185280","2367","1196761","0.32"
"2025-09-24T07:39:15.675Z","Included","auto","No","2575","0","225792","1832","230199","0.07"
"2025-09-24T07:38:27.891Z","Included","auto","No","63772","0","702464","927","767163","0.26"
"2025-09-24T07:35:31.293Z","Included","auto","No","84054","0","2302464","3961","2390479","0.70"
"2025-09-24T07:26:33.854Z","Included","auto","No","101780","0","2597888","14853","2714521","0.87"
"2025-09-24T07:20:48.381Z","Included","auto","No","0","5351","714112","1676","721139","0.20"
"2025-09-24T07:16:20.411Z","Included","auto","No","0","109942","6400","490","116832","0.14"
"2025-09-24T05:50:03.500Z","Included","auto","No","5365","0","971008","2027","978400","0.26"
"2025-09-24T05:20:43.748Z","Included","auto","No","114453","0","1034496","3973","1152922","0.43"
"2025-09-24T05:20:15.341Z","Included","auto","No","628","0","109568","1031","111227","0.03"
"2025-09-24T05:17:37.811Z","Included","auto","No","1397","0","108288","384","110069","0.03"
"2025-09-24T05:16:31.043Z","Errored, Not Charged","auto","No","159150","0","284672","706","444528","0.27"
"2025-09-24T05:03:34.600Z","Included","auto","No","8961","0","723456","1110","733527","0.20"
"2025-09-24T05:01:52.055Z","Included","auto","No","0","0","0","0","0","0.00"
"2025-09-24T04:59:53.747Z","Included","auto","No","5240","0","769536","1099","775875","0.21"
"2025-09-24T04:59:48.150Z","Errored, Not Charged","auto","No","20129","0","55040","91","75260","0.04"
"2025-09-24T04:55:00.367Z","Included","auto","No","48759","109242","365824","24066","547891","0.43"
"2025-09-24T04:53:56.248Z","Errored, Not Charged","auto","No","4065","0","464896","303","469264","0.12"
"2025-09-24T04:53:03.751Z","Included","auto","No","541","0","115456","149","116146","0.03"
"2025-09-24T04:51:46.474Z","Included","auto","No","2472","2948","571136","1413","577969","0.16"
"2025-09-24T04:47:49.595Z","Errored, Not Charged","auto","No","2015","0","336128","382","338525","0.09"
"2025-09-24T04:45:07.301Z","Included","auto","No","7779","0","530944","322","539045","0.14"
"2025-09-24T04:44:48.781Z","Included","auto","No","1328","0","103168","114","104610","0.03"
"2025-09-24T04:44:31.587Z","Included","auto","No","1914","0","101376","1105","104395","0.03"
"2025-09-24T04:43:46.497Z","Errored, Not Charged","auto","No","7284","0","198656","203","206143","0.06"
"2025-09-24T04:39:40.636Z","Errored, Not Charged","auto","No","29990","0","66048","80","96118","0.05"
"2025-09-24T04:30:41.209Z","Included","auto","No","6836","0","677538","1422","685796","0.19"
"2025-09-24T04:28:57.859Z","Errored, Not Charged","auto","No","83434","0","926841","1060","1011335","0.34"
"2025-09-24T04:28:50.623Z","Included","auto","No","382","0","119727","195","120304","0.03"
"2025-09-24T04:28:21.526Z","Included","auto","No","1410","0","118318","280","120008","0.03"
"2025-09-24T04:27:26.327Z","Errored, Not Charged","auto","No","499","0","110696","158","111353","0.03"
"2025-09-24T04:26:48.114Z","Included","auto","No","104","0","110593","391","111088","0.03"
"2025-09-24T04:26:26.421Z","Errored, Not Charged","auto","No","4122","0","173673","165","177960","0.05"
"2025-09-24T04:26:02.166Z","Errored, Not Charged","auto","No","0","0","0","0","0","0.00"
"2025-09-24T04:24:39.773Z","Included","auto","No","57160","104696","29126","14726","205708","0.30"
"2025-09-24T04:23:07.985Z","Errored, Not Charged","auto","No","194823","0","699255","1295","895373","0.43"
"2025-09-24T04:22:06.497Z","Included","auto","No","30662","0","710656","929","742247","0.22"
"2025-09-24T04:21:51.574Z","Included","auto","No","3927","0","127232","157","131316","0.04"
"2025-09-24T04:20:17.578Z","Included","auto","No","63402","0","188160","231","251793","0.13"
"2025-09-24T04:16:55.841Z","Errored, Not Charged","auto","No","151895","77284","1385217","48031","1662427","0.92"
"2025-09-24T04:07:23.793Z","Included","auto","No","44150","109512","2765568","27544","2946774","1.05"
"2025-09-24T04:06:35.104Z","Included","auto","No","0","0","0","0","0","0.00"
"2025-09-24T04:04:46.337Z","Included","auto","No","288","0","114432","69","114789","0.03"
"2025-09-24T04:03:52.496Z","Errored, Not Charged","auto","No","1946","0","566784","565","569295","0.15"
"2025-09-24T04:02:24.652Z","Errored, Not Charged","auto","No","17567","0","1302784","1474","1321825","0.36"
"2025-09-24T04:00:18.631Z","Included","auto","No","23165","0","152064","3056","178285","0.09"
"2025-09-24T03:58:30.247Z","Errored, Not Charged","auto","No","16046","0","2899712","4411","2920169","0.77"
"2025-09-24T03:57:53.682Z","Errored, Not Charged","auto","No","4823","0","90624","70","95517","0.03"
"2025-09-24T03:55:50.049Z","Included","auto","No","5311","0","742912","3356","751579","0.21"
"2025-09-24T03:55:40.096Z","Errored, Not Charged","auto","No","302","0","90624","364","91290","0.03"
"2025-09-24T03:54:44.443Z","Errored, Not Charged","auto","No","64027","0","377088","3401","444516","0.19"
"2025-09-24T03:49:28.349Z","Included","auto","No","88110","335659","656128","22818","1102715","0.83"
"2025-09-24T03:48:44.985Z","Errored, Not Charged","auto","No","1178","0","51456","103","52737","0.01"
"2025-09-24T03:47:31.248Z","Errored, Not Charged","auto","No","4783","0","244736","483","250002","0.07"
"2025-09-24T03:45:58.837Z","Errored, Not Charged","auto","No","20900","88816","26624","20350","156690","0.27"
"2025-09-24T03:45:40.726Z","Errored, Not Charged","auto","No","2538","0","477952","311","480801","0.12"
"2025-09-24T03:44:41.196Z","Errored, Not Charged","auto","No","4375","0","697088","1225","702688","0.19"
"2025-09-24T03:43:47.844Z","Included","auto","No","23474","0","91648","452","115574","0.05"
"2025-09-24T03:42:06.980Z","Included","auto","No","41032","105365","2608640","22568","2777605","0.97"
"2025-09-24T03:41:48.361Z","Errored, Not Charged","auto","No","1194","0","220160","870","222224","0.06"
"2025-09-24T03:40:51.393Z","Errored, Not Charged","auto","No","68628","0","23808","137","92573","0.09"
"2025-09-24T03:32:28.352Z","Included","auto","No","4964","0","448768","2251","455983","0.13"
"2025-09-24T03:25:48.795Z","Errored, Not Charged","auto","No","16823","0","2650624","5421","2672868","0.72"
"2025-09-24T03:24:57.772Z","Errored, Not Charged","auto","No","2354","0","378624","576","381554","0.10"
"2025-09-24T03:24:40.774Z","Errored, Not Charged","auto","No","1740","0","279552","471","281763","0.07"
"2025-09-24T03:24:22.695Z","Errored, Not Charged","auto","No","6697","0","270592","533","277822","0.08"
"2025-09-24T03:16:24.156Z","Included","auto","No","60462","0","3169024","3222","3232708","0.89"
"2025-09-24T03:15:56.336Z","Errored, Not Charged","auto","No","199479","72519","2627072","28067","2927137","1.17"
"2025-09-24T03:15:05.212Z","Included","auto","No","3384","0","193792","1374","198550","0.06"
"2025-09-24T03:14:11.533Z","Errored, Not Charged","auto","No","22421","0","167424","330","190175","0.07"
"2025-09-24T03:10:51.201Z","Included","auto","No","20479","0","1174784","3653","1198916","0.34"
"2025-09-24T03:10:36.659Z","Errored, Not Charged","auto","No","1622","0","294912","317","296851","0.08"
"2025-09-24T03:10:09.736Z","Included","auto","No","2196","0","71168","271","73635","0.02"
"2025-09-24T03:09:39.081Z","Included","auto","No","2418","0","285696","1018","289132","0.08"
"2025-09-24T03:07:18.985Z","Errored, Not Charged","auto","No","53580","82690","254976","20150","411396","0.35"
"2025-09-24T03:06:30.071Z","Included","auto","No","71060","83563","4673536","17320","4845479","1.47"
"2025-09-24T03:05:06.366Z","Errored, Not Charged","auto","No","6331","0","561664","2401","570396","0.16"
"2025-09-24T03:00:11.800Z","Errored, Not Charged","auto","No","32554","0","1627904","4767","1665225","0.48"
"2025-09-24T02:56:52.023Z","Included","auto","No","59145","84360","680448","28284","852237","0.52"
"2025-09-24T02:54:11.460Z","Included","auto","No","6000","0","1054720","1998","1062718","0.28"
"2025-09-24T02:53:51.224Z","Errored, Not Charged","auto","No","3790","0","330752","1023","335565","0.09"
"2025-09-24T02:52:12.111Z","Errored, Not Charged","auto","No","44426","0","977920","2594","1024940","0.32"
"2025-09-24T02:50:16.402Z","Included","auto","No","20089","0","3419392","5236","3444717","0.91"
"2025-09-24T02:49:43.884Z","Included","auto","No","406","0","111872","222","112500","0.03"
"2025-09-24T02:47:54.345Z","Included","auto","No","2289","2094","305920","1059","311362","0.09"
"2025-09-24T02:47:34.973Z","Included","auto","No","0","0","0","0","0","0.00"
"2025-09-24T02:46:51.068Z","Errored, Not Charged","auto","No","1746","2020","303360","631","307757","0.08"
"2025-09-24T02:46:04.143Z","Errored, Not Charged","auto","No","24235","0","176896","259","201390","0.08"
"2025-09-24T02:32:45.187Z","Included","auto","No","380","0","111616","162","112158","0.03"
"2025-09-24T02:32:30.045Z","Included","auto","No","4346","0","330240","330","334916","0.09"
"2025-09-24T02:30:42.344Z","Included","auto","No","3035","0","987136","939","991110","0.26"
"2025-09-24T02:30:15.860Z","Included","auto","No","2207","0","539136","539","541882","0.14"
"2025-09-24T02:30:11.064Z","Errored, Not Charged","auto","No","1075","0","106240","96","107411","0.03"
"2025-09-24T02:29:51.296Z","Errored, Not Charged","auto","No","1835","0","211712","387","213934","0.06"
"2025-09-24T02:29:23.898Z","Errored, Not Charged","auto","No","2660","0","519680","496","522836","0.14"
"2025-09-24T02:28:21.310Z","Included","auto","No","79370","0","23808","592","103770","0.11"
"2025-09-24T02:24:26.582Z","Included","auto","No","174821","76287","1533952","26206","1811266","0.85"
"2025-09-24T02:20:26.971Z","Included","auto","No","29464","338771","260864","13630","642729","0.61"
"2025-09-24T02:20:20.748Z","Included","auto","No","0","0","0","0","0","0.00"
"2025-09-24T02:19:55.304Z","Errored, Not Charged","auto","No","31009","0","259584","972","291565","0.11"
"2025-09-24T02:19:15.402Z","Errored, Not Charged","auto","No","23722","0","648960","938","673620","0.20"
"2025-09-24T02:17:17.335Z","Included","auto","No","48371","0","828160","1230","877761","0.27"
"2025-09-24T02:09:23.321Z","Included","auto","No","172206","72424","3202857","26983","3474470","1.27"
"2025-09-24T02:08:30.688Z","Errored, Not Charged","auto","No","79678","0","1031936","905","1112519","0.36"
"2025-09-24T02:07:38.307Z","Included","auto","No","55949","0","246784","1017","303750","0.14"
"2025-09-24T02:06:39.064Z","Included","auto","No","22270","0","714752","918","737940","0.21"
"2025-09-24T02:04:29.109Z","Included","auto","No","13833","0","1524224","3519","1541576","0.42"
"2025-09-24T02:04:13.624Z","Errored, Not Charged","auto","No","6889","0","369664","533","377086","0.10"
"2025-09-24T02:04:04.958Z","Errored, Not Charged","auto","No","26928","0","45568","383","72879","0.05"
"2025-09-24T02:02:30.469Z","Errored, Not Charged","auto","No","113817","105447","50944","10601","280809","0.35"
"2025-09-24T01:29:21.386Z","Included","auto","No","91952","87775","6350336","22158","6552221","1.95"
"2025-09-24T01:27:23.155Z","Included","auto","No","1398","0","220672","595","222665","0.06"
"2025-09-24T01:27:04.162Z","Included","auto","No","1142","0","218624","1006","220772","0.06"
"2025-09-24T01:23:39.300Z","Included","auto","No","17858","0","3492096","5049","3515003","0.93"
"2025-09-24T01:23:27.646Z","Included","auto","No","332","0","95232","106","95670","0.02"
"2025-09-24T01:23:23.951Z","Errored, Not Charged","auto","No","372","0","94976","58","95406","0.02"
"2025-09-24T01:21:34.080Z","Included","auto","No","3436","0","843520","500","847456","0.22"
"2025-09-24T01:21:33.166Z","Aborted, Not Charged","auto","No","0","0","0","0","0","0.00"
"2025-09-24T01:20:35.596Z","Included","auto","No","1452","0","370432","409","372293","0.10"
"2025-09-24T01:20:08.508Z","Errored, Not Charged","auto","No","85750","0","283136","188","369074","0.18"
"2025-09-24T00:59:26.418Z","Included","auto","No","17703","0","1061015","1496","1080214","0.30"
"2025-09-24T00:55:16.445Z","Included","auto","No","34636","0","743604","1374","779614","0.24"
"2025-09-24T00:51:03.563Z","Included","auto","No","16850","100089","981858","8796","1107593","0.44"
"2025-09-24T00:50:43.683Z","Included","auto","No","474","0","118110","159","118743","0.03"
"2025-09-24T00:50:36.934Z","Errored, Not Charged","auto","No","1587","0","116524","153","118264","0.03"
"2025-09-24T00:50:23.165Z","Errored, Not Charged","auto","No","0","0","0","0","0","0.00"
"2025-09-24T00:50:09.106Z","Errored, Not Charged","auto","No","3402","0","230275","399","234076","0.06"
"2025-09-24T00:49:22.712Z","Errored, Not Charged","auto","No","106598","0","969842","680","1077120","0.38"
"2025-09-24T00:47:21.374Z","Included","auto","No","27229","0","1050112","1176","1078517","0.30"
"2025-09-24T00:39:17.816Z","Included","auto","No","75547","143333","5332224","27801","5578905","1.77"
"2025-09-24T00:38:56.094Z","Included","auto","No","110416","104485","704326","918","920145","0.45"
"2025-09-24T00:23:35.953Z","Included","auto","No","69075","86435","7672891","7917","7836318","2.16"
"2025-09-24T00:21:41.463Z","Included","auto","No","200","86162","98458","61","184881","0.13"
"2025-09-24T00:20:34.904Z","Errored, Not Charged","auto","No","2732","84000","1358665","952","1446349","0.45"
"2025-09-24T00:19:21.476Z","Included","auto","No","35281","38594","464862","849","539586","0.21"
"2025-09-24T00:18:38.864Z","Included","auto","No","868","38265","59704","181","99018","0.06"
"2025-09-24T00:18:23.364Z","Errored, Not Charged","auto","No","338","37132","118956","142","156568","0.08"
"2025-09-24T00:18:15.613Z","Aborted, Not Charged","auto","No","0","0","0","0","0","0.00"
"2025-09-24T00:18:05.475Z","Errored, Not Charged","auto","No","402","36595","118032","165","155194","0.08"
"2025-09-24T00:17:36.335Z","Errored, Not Charged","auto","No","51813","28649","274601","353","355416","0.17"
"2025-09-24T00:16:46.906Z","Errored, Not Charged","auto","No","29414","113236","619890","416","762956","0.34"
"2025-09-24T00:16:17.959Z","Errored, Not Charged","auto","No","4530","107923","689896","444","802793","0.32"
"2025-09-24T00:14:45.700Z","Errored, Not Charged","auto","No","102279","52277","684132","593","839281","0.37"
"2025-09-24T00:09:49.989Z","Included","auto","No","11458","68661","2358016","3185","2441320","0.71"
"2025-09-24T00:07:23.370Z","Errored, Not Charged","auto","No","38068","54221","3355648","5249","3453186","0.99"
"2025-09-24T00:04:11.586Z","Included","auto","No","21098","35523","2813952","4504","2875077","0.80"
"2025-09-24T00:03:40.916Z","Errored, Not Charged","auto","No","61418","35185","6912","149","103664","0.12"
"2025-09-24T00:01:59.461Z","Included","auto","No","42156","0","89691","263","132110","0.08"
"2025-09-23T23:59:43.369Z","Included","auto","No","6679","102706","1449198","2766","1561349","0.52"
"2025-09-23T23:59:22.756Z","Errored, Not Charged","auto","No","1303","97389","214929","378","313999","0.18"
"2025-09-23T23:59:05.929Z","Aborted, Not Charged","auto","No","0","0","0","0","0","0.00"
"2025-09-23T23:57:37.829Z","Errored, Not Charged","auto","No","13015","82015","1712091","2051","1809172","0.56"
"2025-09-23T23:56:34.484Z","Included","auto","No","34382","35408","416256","874","486920","0.20"
"2025-09-23T23:56:07.400Z","Included","auto","No","344","34975","119252","211","154782","0.08"
"2025-09-23T23:55:45.907Z","Errored, Not Charged","auto","No","3169","31338","399531","360","434398","0.15"
"2025-09-23T23:54:51.459Z","Errored, Not Charged","auto","No","4288","29852","439547","687","474374","0.16"
"2025-09-23T23:54:12.815Z","Errored, Not Charged","auto","No","1993","26363","207861","274","236491","0.09"
"2025-09-23T23:53:21.951Z","Errored, Not Charged","auto","No","29978","99170","912645","1687","1043480","0.40"
"2025-09-23T23:52:54.907Z","Errored, Not Charged","auto","No","5669","96976","340331","1240","444216","0.22"
"2025-09-23T23:52:28.527Z","Errored, Not Charged","auto","No","86994","91428","464066","247","642735","0.34"
"2025-09-23T23:51:38.092Z","Included","auto","No","229432","2135295","2711337","45790","5121854","3.91"
"2025-09-23T23:44:29.351Z","Included","auto","No","39452","96790","5260463","5373","5402078","1.52"
"2025-09-23T23:43:32.525Z","Errored, Not Charged","auto","No","19606","77447","1029394","1889","1128336","0.39"
"2025-09-23T23:41:39.941Z","Included","auto","No","38710","32946","871531","1482","944669","0.32"
"2025-09-23T23:41:22.666Z","Aborted, Not Charged","auto","No","0","0","0","0","0","0.00"
"2025-09-23T23:40:53.117Z","Errored, Not Charged","auto","No","11168","32163","264764","258","308353","0.12"
"2025-09-23T23:40:14.772Z","Errored, Not Charged","auto","No","166086","0","341908","563","508557","0.30"
"2025-09-23T23:19:59.138Z","Included","auto","No","84641","85641","1717431","2995","1890708","0.66"
"2025-09-23T23:18:01.694Z","Included","auto","No","1086834","4747647","3213735","92294","9140510","8.65"
"2025-09-23T23:17:32.439Z","Errored, Not Charged","auto","No","36331","0","173540","447","210318","0.09"
"2025-09-23T23:03:02.831Z","Included","auto","No","73062","164586","3313368","13760","3564776","1.21"
"2025-09-23T23:02:25.680Z","Errored, Not Charged","auto","No","3336","74097","446276","276","523985","0.21"
"2025-09-23T23:01:44.493Z","Errored, Not Charged","auto","No","15479","67863","524571","315","608228","0.24"
"2025-09-23T22:57:09.147Z","Included","auto","No","11747","57984","1774739","4962","1849432","0.56"
"2025-09-23T22:53:19.067Z","Included","auto","No","10681","45278","530820","11195","597974","0.27"
"2025-09-23T22:53:16.378Z","Errored, Not Charged","auto","No","0","0","0","0","0","0.00"
"2025-09-23T22:50:24.292Z","Errored, Not Charged","auto","No","36027","104356","963840","2662","1106885","0.43"
"2025-09-23T22:49:43.095Z","Included","auto","No","1445","43580","244974","485","290484","0.12"
"2025-09-23T22:49:20.206Z","Included","auto","No","857","42457","160683","513","204510","0.10"
"2025-09-23T22:49:02.919Z","Included","auto","No","1100","41658","158877","335","201970","0.10"
"2025-09-23T22:48:27.695Z","Errored, Not Charged","auto","No","166788","102264","1152256","5738","1427046","0.66"
"2025-09-23T22:45:06.001Z","Included","auto","No","11384","37886","347431","9042","405743","0.20"
"2025-09-23T22:43:49.392Z","Included","auto","No","25792","21519","874523","2318","924152","0.29"
"2025-09-23T22:43:01.273Z","Included","auto","No","116682","118907","1115648","31713","1382950","0.76"
"2025-09-23T22:41:23.627Z","Included","auto","No","27550","196768","823226","11328","1058872","0.55"
"2025-09-23T22:39:31.000Z","Errored, Not Charged","auto","No","5011","96302","1161983","4283","1267579","0.44"
"2025-09-23T22:38:53.785Z","Errored, Not Charged","auto","No","824","95928","227129","711","324592","0.18"
"2025-09-23T22:38:30.987Z","Included","auto","No","0","0","0","0","0","0.00"
"2025-09-23T22:38:28.038Z","Errored, Not Charged","auto","No","159553","113372","2137344","31905","2442174","1.07"
"2025-09-23T22:36:18.483Z","Errored, Not Charged","auto","No","0","95599","0","8","95607","0.12"
"2025-09-23T22:32:14.595Z","Included","auto","No","35479","61516","1338905","13316","1449216","0.54"
"2025-09-23T22:28:08.314Z","Included","auto","No","17364","49418","429884","3265","499931","0.21"
"2025-09-23T22:24:11.343Z","Included","auto","No","35131","179375","87772","7688","309966","0.34"
"2025-09-23T22:22:27.856Z","Errored, Not Charged","auto","No","112206","85314","455652","2250","655422","0.37"
"2025-09-23T22:19:33.011Z","Errored, Not Charged","auto","No","343603","327683","3355648","116366","4143300","2.38"
"2025-09-23T22:16:40.667Z","Errored, Not Charged","auto","No","51405","186172","1016064","21671","1275312","0.68"
"2025-09-23T22:16:30.721Z","Errored, Not Charged","auto","No","39115","93188","176384","192","308879","0.21"
"2025-09-23T22:11:29.060Z","Errored, Not Charged","auto","No","254832","111400","2155520","22706","2544458","1.13"
"2025-09-23T22:09:52.816Z","Errored, Not Charged","auto","No","154089","110241","502272","4235","770837","0.48"
"2025-09-23T22:08:19.351Z","Included","auto","No","79308","0","676352","2091","757751","0.28"
"2025-09-23T22:04:21.330Z","Included","auto","No","15391","9800","495360","2010","522561","0.17"
"2025-09-23T22:03:47.841Z","Included","auto","No","873","9393","107008","820","118094","0.04"
"2025-09-23T22:03:28.285Z","Errored, Not Charged","auto","No","11401","0","23808","49","35258","0.02"
"2025-09-23T22:02:29.341Z","Included","auto","No","115729","36746","4197583","5434","4355492","1.27"
"2025-09-23T22:00:13.958Z","Included","auto","No","8727","33978","474659","6500","523864","0.21"
"2025-09-23T22:00:01.811Z","Errored, Not Charged","auto","No","1130","30630","55415","65","87240","0.05"
"2025-09-23T21:59:06.015Z","Included","auto","No","361","29418","55055","1018","85852","0.06"
"2025-09-23T21:59:03.288Z","Included","auto","No","0","0","0","0","0","0.00"
"2025-09-23T21:57:04.554Z","Included","auto","No","375","29138","54778","247","84538","0.05"
"2025-09-23T21:56:30.532Z","Errored, Not Charged","auto","No","15425","23523","143398","473","182819","0.09"
"2025-09-23T21:54:04.768Z","Included","auto","No","11739","13511","536292","3078","564620","0.18"
"2025-09-23T21:53:41.526Z","Errored, Not Charged","auto","No","7872","119997","108114","618","236601","0.19"
"2025-09-23T21:53:21.188Z","Errored, Not Charged","auto","No","229053","170085","4924672","39460","5363270","1.97"
"2025-09-23T21:51:56.795Z","Errored, Not Charged","auto","No","26952","188721","262400","14369","492442","0.42"
"2025-09-23T21:51:28.466Z","Errored, Not Charged","auto","No","1096","93507","115968","138","210709","0.15"
"2025-09-23T21:50:54.212Z","Included","auto","No","18290","107881","820205","4497","950873","0.39"
"2025-09-23T21:49:32.133Z","Errored, Not Charged","auto","No","79759","88641","1685527","3079","1857006","0.65"
"2025-09-23T21:46:36.457Z","Included","auto","No","51275","63882","2359808","3597","2478562","0.76"
"2025-09-23T21:45:16.367Z","Included","auto","No","91082","0","1037390","2886","1131358","0.39"
"2025-09-23T21:42:08.806Z","Included","auto","No","112734","112735","2200576","14222","2440267","0.92"
"2025-09-23T21:37:17.462Z","Included","auto","No","199946","110347","5176064","18474","5504831","1.79"
"2025-09-23T21:33:57.172Z","Included","auto","No","4714","81726","199731","225","286396","0.16"
"2025-09-23T21:29:50.137Z","Included","auto","No","121037","123670","495592","16252","756551","0.53"
"2025-09-23T21:26:37.626Z","Included","auto","No","92051","149499","4636928","15083","4893561","1.55"
"2025-09-23T21:24:12.990Z","Included","auto","No","24007","62418","1572096","3047","1661568","0.52"
"2025-09-23T21:22:57.182Z","Included","auto","No","11860","57938","890624","1765","962187","0.32"
"2025-09-23T21:21:10.475Z","Included","auto","No","40135","39076","1770580","5417","1855208","0.57"
"2025-09-23T21:19:38.382Z","Included","auto","No","74212","88676","712960","1584","877432","0.39"
"2025-09-23T21:18:19.820Z","Included","auto","No","21226","86719","690176","1188","799309","0.31"
"2025-09-23T21:17:40.651Z","Errored, Not Charged","auto","No","16982","64030","228352","515","309879","0.16"
"2025-09-23T21:16:40.474Z","Errored, Not Charged","auto","No","112388","81502","1024000","1790","1219680","0.51"
"2025-09-23T21:12:32.421Z","Errored, Not Charged","auto","No","54277","129935","3395159","16674","3596045","1.18"
"2025-09-23T21:11:40.698Z","Included","auto","No","252518","703834","1314304","10367","2281023","1.59"
"2025-09-23T21:10:54.297Z","Included","auto","No","15495","69088","502832","2530","589945","0.25"
"2025-09-23T21:10:20.382Z","Included","auto","No","82977","55599","7060","343","145979","0.18"
"2025-09-23T17:43:35.335Z","Included","auto","No","212838","134673","4566186","21018","4934715","1.70"
"2025-09-23T17:42:28.693Z","Included","auto","No","185417","67363","1425920","2675","1681375","0.69"
"2025-09-23T17:42:11.122Z","Errored, Not Charged","auto","No","2103","65963","253696","761","322523","0.15"
"2025-09-23T17:40:02.722Z","Errored, Not Charged","auto","No","69941","154358","1301248","8145","1533692","0.65"
"2025-09-23T17:28:32.054Z","Errored, Not Charged","auto","No","19650","64443","348928","473","433494","0.20"
"2025-09-23T17:28:00.296Z","Errored, Not Charged","auto","No","33986","40044","301312","1856","377198","0.18"
"2025-09-23T17:27:24.966Z","Errored, Not Charged","auto","No","4988","23648","92416","294","121346","0.06"
"2025-09-23T17:26:27.264Z","Errored, Not Charged","auto","No","9551","114236","261120","1403","386310","0.23"
"2025-09-23T17:19:29.168Z","Included","auto","No","35874","56541","4889764","8367","4990546","1.39"
"2025-09-23T17:05:24.205Z","Included","auto","No","12481","45099","2384468","3810","2445858","0.69"
"2025-09-23T17:01:01.735Z","Errored, Not Charged","auto","No","16105","0","203264","1687","221056","0.08"
"2025-09-23T16:59:46.856Z","Included","auto","No","15682","13947","700416","1921","731966","0.22"
"2025-09-23T16:59:06.704Z","Errored, Not Charged","auto","No","15937","0","398336","1140","415413","0.13"
"2025-09-23T16:56:37.247Z","Included","auto","No","476","93412","114432","162","208482","0.15"
"2025-09-23T16:52:56.170Z","Included","auto","No","6642","87370","444160","608","538780","0.23"
"2025-09-23T16:52:00.085Z","Included","auto","No","231802","105308","2034015","7659","2378784","0.98"
"2025-09-23T16:49:14.545Z","Errored, Not Charged","auto","No","12647","33280","1970496","3862","2020285","0.57"
"2025-09-23T16:49:12.604Z","Errored, Not Charged","auto","No","0","0","0","0","0","0.00"
"2025-09-23T16:43:17.810Z","Included","auto","No","85850","81749","1179904","1982","1349485","0.52"
"2025-09-23T16:42:57.007Z","Errored, Not Charged","auto","No","56853","30524","631643","1113","720133","0.27"
"2025-09-23T16:42:42.424Z","Included","auto","No","274748","41434","2228736","17575","2562493","1.06"
"2025-09-23T09:50:49.866Z","Included","auto","No","0","31250","134144","1732","167126","0.08"
"2025-09-23T09:46:48.578Z","Included","auto","No","0","728575","2031872","18207","2778654","1.53"
"2025-09-23T09:46:32.843Z","Included","auto","No","65476","583246","3274505","13863","3937090","1.71"
"2025-09-23T09:46:27.777Z","Errored, Not Charged","auto","No","0","743372","42496","4785","790653","0.97"
"2025-09-23T09:45:14.710Z","Errored, Not Charged","auto","No","0","720040","0","4225","724265","0.93"
"2025-09-23T09:42:41.495Z","Included","auto","No","0","285829","486144","1263","773236","0.49"
"2025-09-23T09:42:16.956Z","Included","auto","No","0","179937","191744","170","371851","0.27"
"2025-09-23T09:41:32.191Z","Included","auto","No","0","179868","191360","229","371457","0.27"
"2025-09-23T09:40:24.640Z","Included","auto","No","0","359335","11392","275","371002","0.45"
"2025-09-23T09:39:53.794Z","Included","auto","No","0","492515","759936","1451","1253902","0.81"
"2025-09-23T09:36:51.315Z","Errored, Not Charged","auto","No","0","251367","700800","2253","954420","0.50"
"2025-09-23T09:35:11.561Z","Included","auto","No","0","179070","191232","261","370563","0.27"
"2025-09-23T09:34:34.225Z","Included","auto","No","0","179138","381824","140","561102","0.32"
"2025-09-23T09:34:13.366Z","Included","auto","No","0","261429","1558272","3382","1823083","0.74"
"2025-09-23T09:30:37.072Z","Included","auto","No","0","119462","551808","698","671968","0.29"
"2025-09-23T09:29:13.942Z","Errored, Not Charged","auto","No","0","252205","1060608","1087","1313900","0.59"
"2025-09-23T09:28:19.251Z","Included","auto","No","0","10321","442436","48","452805","0.12"
"2025-09-23T09:28:00.157Z","Included","auto","No","0","118179","410496","773","529448","0.25"
"2025-09-23T09:27:38.360Z","Included","auto","No","0","179757","1130752","522","1311031","0.51"
"2025-09-23T09:27:34.607Z","Included","auto","No","0","242712","209536","213","452461","0.36"
"2025-09-23T09:26:36.534Z","Included","auto","No","0","248039","203264","233","451536","0.36"
"2025-09-23T09:25:47.449Z","Included","auto","No","0","441510","418176","1115","860801","0.66"
"2025-09-23T09:24:54.951Z","Included","auto","No","0","196079","445364","600","642043","0.36"
"2025-09-23T09:24:02.593Z","Errored, Not Charged","auto","No","0","423781","11136","2353","437270","0.55"
"2025-09-23T09:20:58.271Z","Included","auto","No","0","527588","396416","1058","925062","0.76"
"2025-09-23T09:20:52.792Z","Included","auto","No","0","366487","679296","939","1046722","0.63"
"2025-09-23T09:00:20.325Z","Included","auto","No","0","106079","494720","699","601498","0.26"
"2025-09-23T08:59:43.566Z","Included","auto","No","0","173038","708480","809","882327","0.40"
"2025-09-23T08:51:17.386Z","Included","auto","No","0","164524","1027840","3416","1195780","0.48"
"2025-09-23T08:48:18.528Z","Included","auto","No","0","213900","548096","1981","763977","0.42"
"2025-09-23T08:46:43.892Z","Included","auto","No","0","376602","552704","1223","930529","0.62"
"2025-09-23T08:45:57.830Z","Included","auto","No","0","311292","1703296","2181","2016769","0.83"
"2025-09-23T08:45:11.150Z","Included","auto","No","0","307914","1798656","4136","2110706","0.86"
"2025-09-23T08:44:47.281Z","Included","auto","No","0","256489","293504","913","550906","0.40"
"2025-09-23T08:42:28.204Z","Included","auto","No","0","372450","11136","362","383948","0.47"
"2025-09-23T07:48:42.914Z","Included","auto","No","0","80712","509184","1718","591614","0.24"
"2025-09-23T07:48:23.792Z","Included","auto","No","0","123051","2136832","3229","2263112","0.71"
"2025-09-23T07:46:59.192Z","Included","auto","No","0","216914","940928","1102","1158944","0.51"
"2025-09-23T07:45:15.773Z","Errored, Not Charged","auto","No","0","238066","641664","2351","882081","0.47"
"2025-09-23T07:43:15.116Z","Included","auto","No","0","228194","542848","2687","773729","0.44"
"2025-09-23T07:43:13.184Z","Errored, Not Charged","auto","No","0","0","0","0","0","0.00"
"2025-09-23T07:43:01.026Z","Errored, Not Charged","auto","No","0","74908","936320","1384","1012612","0.34"
"2025-09-23T07:38:51.104Z","Included","auto","No","0","95740","2158592","8094","2262426","0.71"
"2025-09-23T07:23:53.556Z","Included","auto","No","0","125820","1266304","4453","1396577","0.50"
"2025-09-23T07:20:41.918Z","Included","auto","No","0","281717","454016","4452","740185","0.49"
"2025-09-23T07:08:56.678Z","Included","auto","No","0","75738","205568","1544","282850","0.16"
"2025-09-23T07:00:24.918Z","Included","auto","No","0","0","0","0","0","0.00"
"2025-09-23T07:00:04.185Z","Included","auto","No","0","109614","11392","659","121665","0.14"
"2025-09-23T06:58:00.209Z","Included","auto","No","35795","123414","233474","20143","412826","0.38"
"2025-09-23T06:57:46.718Z","Included","auto","No","69384","169519","3076637","20054","3335594","1.19"
"2025-09-23T06:56:37.029Z","Errored, Not Charged","auto","No","29212","47260","498280","12154","586906","0.29"
"2025-09-23T06:55:25.151Z","Errored, Not Charged","auto","No","41562","131344","356667","1883","531456","0.32"
"2025-09-23T06:46:49.884Z","Included","auto","No","106931","102160","881506","4873","1095470","0.51"
"2025-09-23T06:42:47.081Z","Included","auto","No","37718","76607","5225530","7235","5347090","1.49"
"2025-09-23T06:27:58.227Z","Included","auto","No","32028","101117","277330","3504","413979","0.26"
"2025-09-23T06:23:03.919Z","Included","auto","No","79292","154512","3805244","17487","4056535","1.35"
"2025-09-23T06:22:17.319Z","Included","auto","No","86090","76638","674393","15412","852533","0.46"
"2025-09-23T06:20:12.627Z","Errored, Not Charged","auto","No","55706","230","269385","1944","327265","0.15"
"2025-09-23T06:16:35.468Z","Errored, Not Charged","auto","No","314091","172245","8446090","46857","8979283","3.00"
"2025-09-23T06:15:24.452Z","Errored, Not Charged","auto","No","3176","41984","336586","1291","383037","0.15"
"2025-09-23T06:12:53.940Z","Included","auto","No","40058","213946","7128","12801","273933","0.40"
"2025-09-23T06:12:39.755Z","Included","auto","No","129191","102661","3348524","14033","3594409","1.21"
"2025-09-23T06:03:57.928Z","Included","auto","No","114581","77187","3386008","7559","3585335","1.13"
"2025-09-23T06:02:26.327Z","Included","auto","No","35412","0","631683","2298","669393","0.22"
"2025-09-23T05:56:07.987Z","Errored, Not Charged","auto","No","367454","178542","2369543","19937","2935476","1.39"
"2025-09-23T05:49:37.975Z","Included","auto","No","809","92377","212375","166","305727","0.17"
"2025-09-23T05:47:07.222Z","Included","auto","No","157925","189963","897691","19154","1264733","0.77"
"2025-09-23T05:44:16.359Z","Included","auto","No","72960","68901","2030040","5933","2177834","0.72"
"2025-09-23T05:38:24.287Z","Included","auto","No","19580","84064","3014688","3508","3121840","0.90"
"2025-09-23T05:36:07.955Z","Included","auto","No","78042","106646","1086835","2848","1274371","0.52"
"2025-09-23T05:33:43.037Z","Included","auto","No","87037","74550","1720555","2400","1884542","0.65"
"2025-09-23T05:29:25.729Z","Errored, Not Charged","auto","No","34856","53810","4938496","6393","5033555","1.38"
"2025-09-23T05:26:47.113Z","Included","auto","No","176747","142520","3402439","21942","3743648","1.38"
"2025-09-23T05:25:53.200Z","Included","auto","No","4596","50303","544768","1055","600722","0.21"
"2025-09-23T05:23:58.216Z","Errored, Not Charged","auto","No","55167","41762","1392384","2286","1491599","0.48"
"2025-09-23T05:20:57.219Z","Included","auto","No","9513","29346","610147","2009","651015","0.21"
"2025-09-23T05:18:26.895Z","Errored, Not Charged","auto","No","64705","208887","1368072","14862","1656526","0.77"
"2025-09-23T05:17:01.917Z","Included","auto","No","182959","160356","2876955","12900","3233170","1.23"
"2025-09-23T05:14:50.472Z","Included","auto","No","107574","98338","1532416","1522","1739850","0.65"
"2025-09-23T05:08:40.488Z","Included","auto","No","99392","230754","5042694","25574","5398414","1.83"
"2025-09-23T05:07:01.384Z","Included","auto","No","20104","78434","4629929","4556","4733023","1.31"
"2025-09-23T05:06:13.261Z","Errored, Not Charged","auto","No","51811","73706","425050","1144","551711","0.27"
"2025-09-23T04:59:40.548Z","Errored, Not Charged","auto","No","994","103565","113286","88","217933","0.16"
"2025-09-23T04:58:20.128Z","Included","auto","No","64084","75779","2373362","3820","2517045","0.79"
"2025-09-23T04:57:49.150Z","Included","auto","No","70734","23747","1662156","8414","1765051","0.58"
"2025-09-23T04:56:00.884Z","Errored, Not Charged","auto","No","21870","216070","8877","21947","268764","0.43"
"2025-09-23T04:53:17.329Z","Errored, Not Charged","auto","No","26441","77448","540043","317","644249","0.27"
"2025-09-23T04:49:58.025Z","Included","auto","No","106177","98198","1977844","3755","2185974","0.77"
"2025-09-23T04:48:51.450Z","Included","auto","No","10278","68754","2114260","3991","2197283","0.65"
"2025-09-23T04:48:08.714Z","Errored, Not Charged","auto","No","7561","65933","994362","802","1068658","0.35"
"2025-09-23T04:47:11.033Z","Included","auto","No","32652","69772","579717","2879","685020","0.29"
"2025-09-23T04:46:43.423Z","Errored, Not Charged","auto","No","257241","0","4484836","17665","4759742","1.55"
"2025-09-23T04:41:01.801Z","Errored, Not Charged","auto","No","6060","56488","1271913","2026","1336487","0.41"
"2025-09-23T04:40:40.046Z","Included","auto","No","31455","54821","1432129","6566","1524971","0.51"
"2025-09-23T04:39:29.772Z","Errored, Not Charged","auto","No","8067","52928","853422","4323","918740","0.32"
"2025-09-23T04:38:25.802Z","Errored, Not Charged","auto","No","42879","189980","314412","15387","562658","0.46"
"2025-09-23T04:36:57.659Z","Included","auto","No","2177","41975","160798","2307","207257","0.11"
"2025-09-23T04:33:43.528Z","Included","auto","No","1836","40458","313859","2199","358352","0.14"
"2025-09-23T04:33:13.219Z","Included","auto","No","6686","114194","1293791","7501","1422172","0.52"
"2025-09-23T04:31:02.405Z","Included","auto","No","70937","34496","1484913","3473","1593819","0.52"
"2025-09-23T04:29:30.143Z","Included","auto","No","73743","240341","167072","4957","486113","0.46"
"2025-09-23T04:29:02.183Z","Included","auto","No","89313","76164","1679060","3756","1848293","0.65"
"2025-09-23T04:01:10.993Z","Included","auto","No","61873","139325","7888537","30648","8120383","2.41"
"2025-09-23T04:00:48.085Z","Errored, Not Charged","auto","No","1631","67416","387759","325","457131","0.19"
"2025-09-23T04:00:21.989Z","Included","auto","No","124869","229044","1310545","26606","1691064","0.93"
"2025-09-23T03:55:47.355Z","Included","auto","No","122956","45053","12072808","27972","12268789","3.40"
"2025-09-23T03:54:58.297Z","Errored, Not Charged","auto","No","164737","132052","18256","4589","319634","0.40"
"2025-09-23T03:53:33.988Z","Included","auto","No","17876","50812","3572394","4658","3645740","1.01"
"2025-09-23T03:50:54.922Z","Included","auto","No","71007","48125","1000523","1445","1121100","0.41"
"2025-09-23T03:49:27.057Z","Included","auto","No","110878","0","3591500","5769","3708147","1.07"
"2025-09-23T03:47:04.682Z","Included","auto","No","69293","175409","1196800","20866","1462368","0.73"
"2025-09-23T03:46:24.995Z","Included","auto","No","50334","48885","1260800","16501","1376520","0.54"
"2025-09-23T03:45:33.654Z","Errored, Not Charged","auto","No","3620","48578","64000","3972","120170","0.11"
"2025-09-23T03:44:57.062Z","Errored, Not Charged","auto","No","25571","47927","102144","3440","179082","0.14"
"2025-09-23T03:44:11.219Z","Errored, Not Charged","auto","No","61883","79288","2915328","3476","3059975","0.93"
"2025-09-23T03:42:49.177Z","Errored, Not Charged","auto","No","51715","0","285952","12334","350001","0.21"
"2025-09-23T03:41:04.763Z","Included","auto","No","11185","76396","617661","1316","706558","0.27"
"2025-09-23T03:38:57.060Z","Included","auto","No","8784","68621","1340743","2339","1420487","0.45"
"2025-09-23T03:38:44.017Z","Errored, Not Charged","auto","No","790","67533","157503","207","226033","0.13"
"2025-09-23T03:38:21.722Z","Included","auto","No","550","67117","78128","108","145903","0.10"
"2025-09-23T03:38:12.074Z","Errored, Not Charged","auto","No","1028","66235","154920","210","222393","0.12"
"2025-09-23T03:36:19.811Z","Included","auto","No","2395","63879","531091","1002","598367","0.22"
"2025-09-23T03:35:02.781Z","Included","auto","No","6965","94145","710767","2729","814606","0.32"
"2025-09-23T03:33:55.117Z","Included","auto","No","9508","52765","975325","1429","1039027","0.33"
"2025-09-23T03:32:50.050Z","Included","auto","No","4799","48140","656354","1348","710641","0.24"
"2025-09-23T03:32:33.633Z","Errored, Not Charged","auto","No","2032","46387","227508","378","276305","0.12"
"2025-09-23T03:31:36.889Z","Included","auto","No","48881","41240","588415","1338","679874","0.27"
"2025-09-23T03:30:49.405Z","Included","auto","No","78983","73055","1298142","2467","1452647","0.53"
"2025-09-23T03:28:34.227Z","Included","auto","No","17300","31003","811520","1945","861768","0.27"
"2025-09-23T03:27:47.151Z","Included","auto","No","420536","241808","6823936","48106","7534386","2.82"
"2025-09-23T03:25:45.792Z","Included","auto","No","30309","207090","422912","16319","676630","0.50"
"2025-09-23T03:24:45.193Z","Included","auto","No","39810","39669","2183424","9248","2272151","0.70"
"2025-09-23T03:24:10.961Z","Included","auto","No","17681","19842","131072","1519","170114","0.09"
"2025-09-23T03:23:17.602Z","Included","auto","No","21009","1868","70400","1027","94304","0.05"
"2025-09-23T03:22:27.789Z","Included","auto","No","2388","0","66816","541","69745","0.02"
"2025-09-23T03:21:19.956Z","Included","auto","No","2149","44343","352633","678","399803","0.15"
"2025-09-23T03:19:40.573Z","Included","auto","No","62376","41881","895378","1439","1001074","0.36"
"2025-09-23T03:18:02.399Z","Included","auto","No","171523","93628","4020138","7319","4292608","1.38"
"2025-09-23T03:15:41.764Z","Included","auto","No","217384","98848","1577415","2728","1896375","0.81"
"2025-09-23T03:13:02.532Z","Included","auto","No","102769","96617","1182720","1255","1383361","0.55"
"2025-09-23T03:08:00.591Z","Included","auto","No","182322","222153","3507344","16561","3928380","1.48"
"2025-09-23T03:06:47.768Z","Included","auto","No","37922","110259","190852","318","339351","0.23"
"2025-09-23T03:04:58.760Z","Included","auto","No","11750","85576","2978742","3534","3079602","0.89"
"2025-09-23T03:01:57.844Z","Included","auto","No","38209","44424","1652671","3002","1738306","0.53"
"2025-09-23T03:01:26.590Z","Included","auto","No","23662","42962","87198","386","154208","0.11"
"2025-09-23T03:00:22.514Z","Included","auto","No","7786","35875","503424","2233","549318","0.19"
"2025-09-23T02:59:54.774Z","Errored, Not Charged","auto","No","10190","32888","309965","738","353781","0.14"
"2025-09-23T02:58:39.860Z","Included","auto","No","145011","67466","3965532","7757","4185766","1.30"
"2025-09-23T02:56:58.250Z","Errored, Not Charged","auto","No","37073","180752","1307884","15599","1541308","0.69"
"2025-09-23T02:54:51.875Z","Errored, Not Charged","auto","No","8401","86228","2011847","2605","2109081","0.64"
"2025-09-23T02:50:27.238Z","Included","auto","No","30981","75716","3148913","5370","3260980","0.95"
"2025-09-23T02:49:47.040Z","Included","auto","No","106572","94845","2004637","5836","2211890","0.79"
"2025-09-23T02:47:18.583Z","Included","auto","No","13087","58662","2407705","3853","2483307","0.71"
"2025-09-23T02:46:58.861Z","Errored, Not Charged","auto","No","624","57958","211768","383","270733","0.13"
"2025-09-23T02:46:42.183Z","Included","auto","No","617","57589","69693","197","128096","0.09"
"2025-09-23T02:45:15.215Z","Included","auto","No","13749","43177","1271487","2049","1330462","0.40"
"2025-09-23T02:42:50.640Z","Included","auto","No","12237","39638","469026","1502","522403","0.19"
"2025-09-23T02:41:31.319Z","Included","auto","No","8762","31947","704885","1791","747385","0.24"
"2025-09-23T02:40:39.562Z","Errored, Not Charged","auto","No","9698","27195","230473","2237","269603","0.12"
"2025-09-23T02:39:29.265Z","Included","auto","No","96578","167331","2741556","12244","3017709","1.09"
"2025-09-23T02:35:09.637Z","Included","auto","No","31943","179829","1057647","9191","1278610","0.58"
"2025-09-23T02:34:22.357Z","Included","auto","No","91987","165806","440385","22909","721087","0.57"
"2025-09-23T02:28:19.554Z","Included","auto","No","44736","0","3340330","5173","3390239","0.92"
"2025-09-23T02:24:40.407Z","Included","auto","No","21701","0","1252325","1589","1275615","0.35"
"2025-09-23T02:24:08.353Z","Included","auto","No","32604","0","138906","958","172468","0.08"
"2025-09-23T02:23:08.263Z","Included","auto","No","7383","0","198954","424","206761","0.06"
"2025-09-23T02:22:17.676Z","Errored, Not Charged","auto","No","10687","0","1168190","1067","1179944","0.31"
"2025-09-23T02:21:51.296Z","Errored, Not Charged","auto","No","11566","0","159047","1538","172151","0.06"
"2025-09-23T02:21:12.015Z","Included","auto","No","32102","104668","75864","21576","234210","0.32"
"2025-09-23T02:20:43.094Z","Errored, Not Charged","auto","No","0","0","0","0","0","0.00"
"2025-09-23T02:18:39.759Z","Included","auto","No","9292","0","1503010","3401","1515703","0.41"
"2025-09-23T02:18:26.052Z","Errored, Not Charged","auto","No","963","0","148500","232","149695","0.04"
"2025-09-23T02:18:01.449Z","Errored, Not Charged","auto","No","1682","0","365150","368","367200","0.10"
"2025-09-23T02:17:27.414Z","Errored, Not Charged","auto","No","108587","0","2584610","5623","2698820","0.82"
"2025-09-23T02:16:02.901Z","Included","auto","No","65113","0","730633","5004","800750","0.29"
"2025-09-23T02:10:18.577Z","Included","auto","No","50842","0","1745408","5768","1802018","0.53"
"2025-09-23T02:04:40.356Z","Errored, Not Charged","auto","No","24824","92758","1910161","11678","2039421","0.69"
"2025-09-23T02:04:13.522Z","Included","auto","No","1797","0","109659","1040","112496","0.04"
"2025-09-23T02:02:57.374Z","Included","auto","No","559","0","109101","1659","111319","0.04"
"2025-09-23T02:02:13.303Z","Included","auto","No","93470","85285","4630783","24948","4834486","1.53"
"2025-09-23T02:00:05.820Z","Included","auto","No","12478","0","1257961","2419","1272858","0.34"
"2025-09-23T01:56:07.313Z","Included","auto","No","109410","0","100191","561","210162","0.17"
"2025-09-23T01:53:50.856Z","Included","auto","No","98269","0","1310720","2075","1411064","0.46"
"2025-09-23T01:51:50.237Z","Included","auto","No","6086","0","1767209","3487","1776782","0.47"
"2025-09-23T01:46:57.692Z","Included","auto","No","83443","0","187830","170","271443","0.15"
"2025-09-23T01:27:12.447Z","Included","auto","No","6947","0","876721","898","884566","0.23"
"2025-09-23T01:23:50.061Z","Included","auto","No","28093","2273","1765891","3777","1800034","0.50"
"2025-09-23T01:18:58.248Z","Included","auto","No","15222","3686","2216849","6030","2241787","0.61"
"2025-09-23T01:17:36.585Z","Errored, Not Charged","auto","No","5434","6884","597999","3344","613661","0.18"
"2025-09-23T01:13:07.766Z","Included","auto","No","44611","0","1283894","5156","1333661","0.41"
"2025-09-23T01:03:01.148Z","Included","auto","No","38924","96836","3490761","12686","3639207","1.12"
"2025-09-23T01:00:45.991Z","Included","auto","No","5522","0","1727194","3044","1735760","0.46"
"2025-09-23T01:00:21.528Z","Included","auto","No","231","0","99038","150","99419","0.03"
"2025-09-23T01:00:05.725Z","Errored, Not Charged","auto","No","719","0","295288","250","296257","0.08"
"2025-09-23T00:59:03.162Z","Included","auto","No","2107","0","290780","833","293720","0.08"
"2025-09-23T00:56:31.632Z","Included","auto","No","5504","0","1119739","2773","1128016","0.30"
"2025-09-23T00:53:05.311Z","Errored, Not Charged","auto","No","9380","0","1182625","2531","1194536","0.32"
"2025-09-23T00:50:40.138Z","Included","auto","No","10955","0","2423543","2708","2437206","0.64"
"2025-09-23T00:48:25.484Z","Included","auto","No","65157","98408","360454","7303","531322","0.34"
"2025-09-23T00:18:38.956Z","Included","auto","No","149904","0","1081353","2397","1233654","0.47"
"2025-09-23T00:05:04.491Z","Errored, Not Charged","auto","No","8048","0","1577249","1373","1586670","0.41"
"2025-09-23T00:02:48.711Z","Included","auto","No","403","0","190552","467","191422","0.05"
"2025-09-23T00:00:13.436Z","Included","auto","No","89932","61227","2590444","24501","2766104","0.98"
"2025-09-22T23:56:48.488Z","Included","auto","No","1375","0","250590","482","252447","0.07"
"2025-09-22T23:56:00.572Z","Included","auto","No","40333","0","2589309","5092","2634734","0.73"
"2025-09-22T23:52:27.479Z","Errored, Not Charged","auto","No","32031","0","886728","6692","925451","0.30"
"2025-09-22T23:50:43.972Z","Included","auto","No","4011","1400","98463","3781","107655","0.05"
"2025-09-22T23:49:31.826Z","Included","auto","No","6052","0","41217","419","47688","0.02"
"2025-09-22T23:48:47.176Z","Included","auto","No","10549","0","58517","437","69503","0.03"
"2025-09-22T23:48:16.829Z","Included","auto","No","177451","66801","1099357","14338","1357947","0.67"
"2025-09-22T22:15:50.435Z","Included","auto","No","44439","0","2644838","14234","2703511","0.80"
"2025-09-22T22:13:16.010Z","Included","auto","No","19386","0","327791","1511","348688","0.12"
"2025-09-22T22:08:40.523Z","Included","auto","No","14621","0","1207804","3668","1226093","0.34"
"2025-09-22T22:06:53.141Z","Errored, Not Charged","auto","No","10644","0","625524","1608","637776","0.18"
"2025-09-22T22:03:02.974Z","Included","auto","No","46616","0","2715905","2772","2765293","0.75"
"2025-09-22T21:58:52.774Z","Included","auto","No","189540","26028","16392","11170","243130","0.34"
"2025-09-22T21:39:00.579Z","Included","auto","No","9006","0","2599286","2973","2611265","0.68"
"2025-09-22T21:38:44.177Z","Included","auto","No","62019","0","948398","1840","1012257","0.33"
"2025-09-22T21:37:49.229Z","Included","auto","No","101599","0","114948","616","217163","0.16"
"2025-09-22T21:32:34.476Z","Included","auto","No","34633","100214","1115772","13660","1264279","0.53"
"2025-09-22T21:28:48.298Z","Included","auto","No","15659","0","2510078","6251","2531988","0.68"
"2025-09-22T21:25:26.652Z","Included","auto","No","44128","0","2055510","5106","2104744","0.60"
"2025-09-22T21:23:29.420Z","Included","auto","No","51125","0","553970","1629","606724","0.21"
"2025-09-22T21:11:57.411Z","Included","auto","No","154700","0","2184358","4140","2343198","0.76"
"2025-09-22T20:57:43.774Z","Included","auto","No","99264","0","1437323","2892","1539479","0.50"
"2025-09-22T20:54:59.699Z","Included","auto","No","321033","130916","7114336","28650","7594935","2.52"
"2025-09-22T20:52:33.083Z","Included","auto","No","29137","94555","337770","8310","469772","0.29"
"2025-09-22T20:51:25.223Z","Errored, Not Charged","auto","No","104448","0","749360","1950","855758","0.33"
"2025-09-22T20:31:14.637Z","Included","auto","No","97379","0","2077562","4895","2179836","0.67"
"2025-09-22T20:23:38.171Z","Included","auto","No","3034","0","382863","1938","387835","0.11"
"2025-09-22T20:23:26.999Z","Errored, Not Charged","auto","No","87091","0","7138","115","94344","0.11"
"2025-09-22T20:22:11.496Z","Included","auto","No","167519","0","3671227","10034","3848780","1.19"
"2025-09-22T20:21:24.790Z","Included","auto","No","90736","0","377549","868","469153","0.21"
"2025-09-22T20:19:40.257Z","Included","auto","No","43506","0","184146","652","228304","0.10"
"2025-09-22T20:16:06.349Z","Included","auto","No","57585","70838","470670","15974","615067","0.37"
"2025-09-22T20:09:09.915Z","Included","auto","No","94273","0","207983","1011","303267","0.18"
"2025-09-22T19:23:09.477Z","Included","auto","No","122972","0","3418485","28637","3570094","1.18"
"2025-09-22T19:22:42.599Z","Included","auto","No","86627","0","563106","452","650185","0.25"
"2025-09-22T19:21:29.425Z","Errored, Not Charged","auto","No","58733","0","408106","1219","468058","0.18"
"2025-09-22T19:16:29.163Z","Included","auto","No","186794","100033","2218799","21944","2527570","1.04"
"2025-09-22T19:00:41.428Z","Included","auto","No","128734","0","2749274","19232","2897240","0.96"
"2025-09-22T19:00:40.329Z","Aborted, Not Charged","auto","No","0","0","0","0","0","0.00"
"2025-09-22T18:59:24.960Z","Included","auto","No","4936","705","116200","483","122324","0.04"
"2025-09-22T18:48:42.030Z","Included","auto","No","33744","0","1173764","3888","1211396","0.36"
"2025-09-22T18:48:10.861Z","Included","auto","No","15009","0","66047","329","81385","0.04"
"2025-09-22T07:25:56.885Z","Included","claude-4-sonnet-thinking","Yes","243","353","214417","157","215170","0.02"
"2025-09-22T07:25:51.392Z","Included","claude-4-sonnet-thinking","Yes","200","348","214217","90","214855","0.02"
"2025-09-22T07:25:47.075Z","Included","claude-4-sonnet-thinking","Yes","203706","16","10511","90","214323","0.18"
"2025-09-22T07:10:23.377Z","Included","claude-4-sonnet-thinking","Yes","265","385","213571","388","214609","0.02"
"2025-09-22T07:10:15.128Z","Included","claude-4-sonnet-thinking","Yes","166","358","213405","137","214066","0.02"
"2025-09-22T07:10:09.541Z","Included","claude-4-sonnet-thinking","Yes","270","361","213135","95","213861","0.02"
"2025-09-22T07:10:03.479Z","Included","claude-4-sonnet-thinking","Yes","378","358","212757","98","213591","0.02"
"2025-09-22T07:09:56.642Z","Included","claude-4-sonnet-thinking","Yes","306","358","212451","106","213221","0.02"
"2025-09-22T07:09:45.989Z","Included","claude-4-sonnet-thinking","Yes","388","487","212063","95","213033","0.02"
"2025-09-22T07:09:03.731Z","Included","claude-4-sonnet-thinking","Yes","263","375","211800","276","212714","0.02"
"2025-09-22T07:08:41.477Z","Included","claude-4-sonnet-thinking","Yes","1922","374","209878","187","212361","0.02"
"2025-09-22T07:08:31.416Z","Included","claude-4-sonnet-thinking","Yes","740","0","209138","112","209990","0.02"
"2025-09-22T07:08:24.324Z","Included","claude-4-sonnet-thinking","Yes","319","0","208819","393","209531","0.02"
"2025-09-22T07:08:02.725Z","Included","claude-4-sonnet-thinking","Yes","2070","369","206749","214","209402","0.02"
"2025-09-22T07:07:56.573Z","Included","claude-4-sonnet-thinking","Yes","484","0","206265","107","206856","0.02"
"2025-09-22T07:07:50.928Z","Included","claude-4-sonnet-thinking","Yes","365","0","205900","225","206490","0.02"
"2025-09-22T07:07:32.558Z","Included","claude-4-sonnet-thinking","Yes","748","369","205152","166","206435","0.02"
"2025-09-22T07:07:24.441Z","Included","claude-4-sonnet-thinking","Yes","454","0","204698","106","205258","0.02"
"2025-09-22T07:07:19.159Z","Included","claude-4-sonnet-thinking","Yes","544","0","204154","337","205035","0.02"
"2025-09-22T07:07:01.902Z","Included","claude-4-sonnet-thinking","Yes","573","369","203581","158","204681","0.02"
"2025-09-22T07:06:54.438Z","Included","claude-4-sonnet-thinking","Yes","456","0","203125","107","203688","0.02"
"2025-09-22T07:06:48.934Z","Included","claude-4-sonnet-thinking","Yes","727","0","202398","341","203466","0.02"
"2025-09-22T07:06:42.991Z","Included","claude-4-sonnet-thinking","Yes","217","0","202181","139","202537","0.02"
"2025-09-22T07:06:35.501Z","Included","claude-4-sonnet-thinking","Yes","555","0","201626","119","202300","0.02"
"2025-09-22T07:06:17.580Z","Included","claude-4-sonnet-thinking","Yes","906","369","200720","307","202302","0.02"
"2025-09-22T07:06:11.365Z","Included","claude-4-sonnet-thinking","Yes","169","348","200551","133","201201","0.02"
"2025-09-22T07:06:07.055Z","Included","claude-4-sonnet-thinking","Yes","175","351","200376","85","200987","0.01"
"2025-09-22T07:05:56.347Z","Included","claude-4-sonnet-thinking","Yes","503","452","199873","111","200939","0.02"
"2025-09-22T07:05:07.770Z","Included","claude-4-sonnet-thinking","Yes","339","349","199534","233","200455","0.02"
"2025-09-22T07:04:58.629Z","Included","claude-4-sonnet-thinking","Yes","237","356","199297","110","200000","0.01"
"2025-09-22T07:04:42.351Z","Included","claude-4-sonnet-thinking","Yes","214","355","199083","140","199792","0.02"
"2025-09-22T07:04:32.954Z","Included","claude-4-sonnet-thinking","Yes","1823","351","197260","150","199584","0.02"
"2025-09-22T07:04:17.200Z","Included","claude-4-sonnet-thinking","Yes","196","351","197064","88","197699","0.01"
"2025-09-22T07:04:05.203Z","Included","claude-4-sonnet-thinking","Yes","5472","2974","191592","595","200633","0.02"
"2025-09-22T07:04:01.169Z","Included","claude-4-sonnet-thinking","Yes","181081","4780","10511","139","196511","0.17"
"2025-09-22T06:36:40.653Z","Included","claude-4-sonnet-thinking","Yes","379","358","190855","397","191989","0.02"
"2025-09-22T06:35:47.744Z","Included","claude-4-sonnet-thinking","Yes","265","385","190590","121","191361","0.01"
"2025-09-22T06:35:41.184Z","Included","claude-4-sonnet-thinking","Yes","271","357","190319","137","191084","0.01"
"2025-09-22T06:35:34.104Z","Included","claude-4-sonnet-thinking","Yes","297","357","190022","106","190782","0.01"
"2025-09-22T06:35:17.531Z","Included","claude-4-sonnet-thinking","Yes","414","511","189608","119","190652","0.01"
"2025-09-22T06:34:36.405Z","Included","claude-4-sonnet-thinking","Yes","206","375","189402","299","190282","0.01"
"2025-09-22T06:34:15.390Z","Included","claude-4-sonnet-thinking","Yes","229","355","189173","130","189887","0.01"
"2025-09-22T06:34:03.068Z","Included","claude-4-sonnet-thinking","Yes","1828","351","187345","113","189637","0.02"
"2025-09-22T06:33:55.099Z","Included","claude-4-sonnet-thinking","Yes","285","351","187060","99","187795","0.01"
"2025-09-22T06:33:43.754Z","Included","claude-4-sonnet-thinking","Yes","194","349","186866","119","187528","0.01"
"2025-09-22T06:33:33.325Z","Included","claude-4-sonnet-thinking","Yes","740","0","186126","93","186959","0.01"
"2025-09-22T06:33:27.692Z","Included","claude-4-sonnet-thinking","Yes","292","0","185834","393","186519","0.02"
"2025-09-22T06:33:19.457Z","Included","claude-4-sonnet-thinking","Yes","291","0","185543","122","185956","0.01"
"2025-09-22T06:33:13.242Z","Included","claude-4-sonnet-thinking","Yes","285","0","185258","176","185719","0.01"
"2025-09-22T06:33:07.347Z","Errored, Not Charged","claude-4-sonnet-thinking","Yes","259","0","184999","107","185365","0.01"
"2025-09-22T06:32:56.681Z","Included","claude-4-sonnet-thinking","Yes","369","349","184630","204","185552","0.01"
"2025-09-22T06:32:39.183Z","Included","claude-4-sonnet-thinking","Yes","189","351","184441","114","185095","0.01"
"2025-09-22T06:32:28.155Z","Included","claude-4-sonnet-thinking","Yes","415","0","184026","90","184531","0.01"
"2025-09-22T06:32:22.818Z","Included","claude-4-sonnet-thinking","Yes","478","0","183548","298","184324","0.01"
"2025-09-22T06:32:14.985Z","Included","claude-4-sonnet-thinking","Yes","457","0","183091","142","183690","0.01"
"2025-09-22T06:32:07.260Z","Included","claude-4-sonnet-thinking","Yes","487","0","182604","195","183286","0.01"
"2025-09-22T06:32:00.222Z","Included","claude-4-sonnet-thinking","Yes","394","0","182210","215","182819","0.01"
"2025-09-22T06:31:18.090Z","Errored, Not Charged","claude-4-sonnet-thinking","Yes","1057","0","181153","126","182336","0.01"
"2025-09-22T06:30:57.172Z","Included","claude-4-sonnet-thinking","Yes","771","0","180382","561","181714","0.02"
"2025-09-22T06:30:51.788Z","Included","claude-4-sonnet-thinking","Yes","539","0","179843","399","180781","0.01"
"2025-09-22T06:30:44.205Z","Included","claude-4-sonnet-thinking","Yes","588","0","179255","138","179981","0.01"
"2025-09-22T06:30:27.907Z","Included","claude-4-sonnet-thinking","Yes","874","351","178381","340","179946","0.01"
"2025-09-22T06:30:16.227Z","Included","claude-4-sonnet-thinking","Yes","1470","0","176911","91","178472","0.01"
"2025-09-22T06:30:11.216Z","Included","claude-4-sonnet-thinking","Yes","1089","0","175822","979","177890","0.02"
"2025-09-22T06:29:55.330Z","Included","claude-4-sonnet-thinking","Yes","1684","351","174138","148","176321","0.01"
"2025-09-22T06:29:49.091Z","Included","claude-4-sonnet-thinking","Yes","838","348","173300","101","174587","0.01"
"2025-09-22T06:29:43.896Z","Included","claude-4-sonnet-thinking","Yes","4427","357","168873","85","173742","0.02"
"2025-09-22T06:29:37.610Z","Included","claude-4-sonnet-thinking","Yes","158362","4128","10511","120","173121","0.15"
"2025-09-22T06:21:35.971Z","Included","claude-4-sonnet-thinking","Yes","374","358","168228","310","169270","0.01"
"2025-09-22T06:21:29.514Z","Included","claude-4-sonnet-thinking","Yes","391","364","167837","116","168708","0.01"
"2025-09-22T06:21:23.043Z","Included","claude-4-sonnet-thinking","Yes","202","350","167635","101","168288","0.01"
"2025-09-22T06:21:18.854Z","Included","claude-4-sonnet-thinking","Yes","193","16","167442","92","167743","0.01"
"2025-09-22T06:20:20.461Z","Included","claude-4-sonnet-thinking","Yes","446","589","166996","200","168231","0.01"
"2025-09-22T06:20:14.602Z","Included","claude-4-sonnet-thinking","Yes","259","353","166737","362","167711","0.01"
"2025-09-22T06:20:06.109Z","Included","claude-4-sonnet-thinking","Yes","211","348","166526","128","167213","0.01"
"2025-09-22T06:20:02.645Z","Included","claude-4-sonnet-thinking","Yes","156015","19","10511","98","166643","0.14"
"2025-09-22T06:14:42.908Z","Included","claude-4-sonnet-thinking","Yes","0","15","166004","504","166523","0.01"
"2025-09-22T05:59:21.057Z","Errored, Not Charged","claude-4-sonnet-thinking","No","0","484","0","10","494","0.000"
"2025-09-22T05:44:05.444Z","Errored, Not Charged","claude-4-sonnet-thinking","No","0","716","0","10","726","0.000"
"2025-09-22T05:43:57.448Z","Included","claude-4-sonnet-thinking","Yes","962","0","164555","440","165957","0.01"
"2025-09-22T05:43:17.096Z","Included","claude-4-sonnet-thinking","Yes","221","375","164334","274","165204","0.01"
"2025-09-22T05:43:04.418Z","Included","claude-4-sonnet-thinking","Yes","585","368","163749","145","164847","0.01"
"2025-09-22T05:42:58.437Z","Included","claude-4-sonnet-thinking","Yes","475","0","163274","104","163853","0.01"
"2025-09-22T05:42:46.138Z","Included","claude-4-sonnet-thinking","Yes","966","368","162308","228","163870","0.01"
"2025-09-22T05:42:37.793Z","Included","claude-4-sonnet-thinking","Yes","220","380","162088","137","162825","0.01"
"2025-09-22T05:41:58.756Z","Included","claude-4-sonnet-thinking","Yes","257","374","161831","139","162601","0.01"
"2025-09-22T05:41:18.316Z","Included","claude-4-sonnet-thinking","Yes","237","375","161594","171","162377","0.01"
"2025-09-22T05:41:05.845Z","Included","claude-4-sonnet-thinking","Yes","611","369","160983","156","162119","0.01"
"2025-09-22T05:40:53.385Z","Included","claude-4-sonnet-thinking","Yes","582","367","160401","138","161488","0.01"
"2025-09-22T05:40:37.240Z","Included","claude-4-sonnet-thinking","Yes","1403","0","158998","104","160505","0.01"
"2025-09-22T05:40:20.005Z","Included","claude-4-sonnet-thinking","Yes","4429","367","154569","864","160229","0.02"
"2025-09-22T05:40:13.172Z","Included","claude-4-sonnet-thinking","Yes","503","0","154066","101","154670","0.01"
"2025-09-22T05:40:08.705Z","Included","claude-4-sonnet-thinking","Yes","305","0","153761","239","154305","0.01"
"2025-09-22T05:40:03.745Z","Included","claude-4-sonnet-thinking","Yes","395","0","153366","148","153909","0.01"
"2025-09-22T05:39:48.617Z","Included","claude-4-sonnet-thinking","Yes","4458","367","148908","234","153967","0.02"
"2025-09-22T05:39:40.501Z","Included","claude-4-sonnet-thinking","Yes","218","379","148690","136","149423","0.01"
"2025-09-22T05:39:03.430Z","Included","claude-4-sonnet-thinking","Yes","268","367","148422","137","149194","0.01"
"2025-09-22T05:38:26.107Z","Included","claude-4-sonnet-thinking","Yes","252","375","148170","122","148919","0.01"
"2025-09-22T05:38:13.960Z","Included","claude-4-sonnet-thinking","Yes","591","369","147579","134","148673","0.01"
"2025-09-22T05:38:06.860Z","Included","claude-4-sonnet-thinking","Yes","561","0","147018","104","147683","0.01"
"2025-09-22T05:37:54.028Z","Included","claude-4-sonnet-thinking","Yes","971","369","146047","288","147675","0.01"
"2025-09-22T05:37:45.885Z","Included","claude-4-sonnet-thinking","Yes","303","380","145744","124","146551","0.01"
"2025-09-22T05:37:06.615Z","Included","claude-4-sonnet-thinking","Yes","223","375","145521","186","146305","0.01"
"2025-09-22T05:36:55.094Z","Included","claude-4-sonnet-thinking","Yes","612","375","144909","142","146038","0.01"
"2025-09-22T05:36:49.189Z","Included","claude-4-sonnet-thinking","Yes","307","0","144602","112","145021","0.01"
"2025-09-22T05:36:44.768Z","Included","claude-4-sonnet-thinking","Yes","295","0","144307","151","144753","0.01"
"2025-09-22T05:36:32.719Z","Included","claude-4-sonnet-thinking","Yes","1007","375","143300","139","144821","0.01"
"2025-09-22T05:36:26.362Z","Included","claude-4-sonnet-thinking","Yes","688","0","142612","112","143412","0.01"
"2025-09-22T05:36:11.807Z","Included","claude-4-sonnet-thinking","Yes","4538","375","138074","353","143340","0.02"
"2025-09-22T05:36:06.252Z","Included","claude-4-sonnet-thinking","Yes","284","0","137790","117","138191","0.01"
"2025-09-22T05:36:01.263Z","Included","claude-4-sonnet-thinking","Yes","253","0","137537","142","137932","0.01"
"2025-09-22T05:35:55.710Z","Errored, Not Charged","claude-4-sonnet-thinking","Yes","244","0","137293","107","137644","0.01"
"2025-09-22T05:35:49.883Z","Included","claude-4-sonnet-thinking","Yes","651","0","136642","142","137435","0.01"
"2025-09-22T05:35:44.007Z","Included","claude-4-sonnet-thinking","Yes","491","0","136151","285","136927","0.01"
"2025-09-22T05:35:26.819Z","Included","claude-4-sonnet-thinking","Yes","4519","370","131632","276","136797","0.01"
"2025-09-22T05:35:14.314Z","Included","claude-4-sonnet-thinking","Yes","583","366","131049","147","132145","0.01"
"2025-09-22T05:35:08.109Z","Included","claude-4-sonnet-thinking","Yes","487","0","130562","106","131155","0.01"
"2025-09-22T05:34:52.647Z","Included","claude-4-sonnet-thinking","Yes","4549","366","126013","257","131185","0.01"
"2025-09-22T05:34:12.058Z","Included","claude-4-sonnet-thinking","Yes","223","375","125790","166","126554","0.01"
"2025-09-22T05:33:58.934Z","Included","claude-4-sonnet-thinking","Yes","593","370","125197","142","126302","0.01"
"2025-09-22T05:33:40.626Z","Included","claude-4-sonnet-thinking","Yes","1458","0","123739","109","125306","0.01"
"2025-09-22T05:33:35.906Z","Included","claude-4-sonnet-thinking","Yes","190","0","123549","785","124524","0.01"
"2025-09-22T05:33:31.151Z","Included","claude-4-sonnet-thinking","Yes","594","0","122955","119","123668","0.01"
"2025-09-22T05:33:26.623Z","Included","claude-4-sonnet-thinking","Yes","203","0","122752","123","123078","0.01"
"2025-09-22T05:33:21.557Z","Included","claude-4-sonnet-thinking","Yes","180","0","122572","132","122884","0.01"
"2025-09-22T05:33:16.886Z","Included","claude-4-sonnet-thinking","Yes","191","0","122381","109","122681","0.01"
"2025-09-22T05:33:02.962Z","Included","claude-4-sonnet-thinking","Yes","4502","370","117879","171","122922","0.01"
"2025-09-22T05:32:54.012Z","Included","claude-4-sonnet-thinking","Yes","356","380","117523","130","118389","0.01"
"2025-09-22T05:32:14.577Z","Included","claude-4-sonnet-thinking","Yes","223","375","117300","204","118102","0.01"
"2025-09-22T05:32:01.979Z","Included","claude-4-sonnet-thinking","Yes","584","367","116716","142","117809","0.01"
"2025-09-22T05:31:54.416Z","Included","claude-4-sonnet-thinking","Yes","750","0","115966","106","116822","0.01"
"2025-09-22T05:31:49.195Z","Included","claude-4-sonnet-thinking","Yes","361","0","115605","415","116381","0.01"
"2025-09-22T05:31:45.337Z","Included","claude-4-sonnet-thinking","Yes","167","0","115438","107","115712","0.01"
"2025-09-22T05:31:41.042Z","Included","claude-4-sonnet-thinking","Yes","372","0","115066","101","115539","0.01"
"2025-09-22T05:31:35.896Z","Included","claude-4-sonnet-thinking","Yes","240","0","114826","130","115196","0.01"
"2025-09-22T05:31:20.187Z","Included","claude-4-sonnet-thinking","Yes","4476","367","110350","220","115413","0.01"
"2025-09-22T05:31:12.413Z","Included","claude-4-sonnet-thinking","Yes","425","381","109925","144","110875","0.01"
"2025-09-22T05:31:02.425Z","Included","claude-4-sonnet-thinking","Yes","242","379","109683","195","110499","0.01"
"2025-09-22T05:30:53.562Z","Included","claude-4-sonnet-thinking","Yes","955","0","108728","151","109834","0.01"
"2025-09-22T05:30:46.676Z","Included","claude-4-sonnet-thinking","Yes","392","504","108336","288","109520","0.01"
"2025-09-22T05:30:37.277Z","Included","claude-4-sonnet-thinking","Yes","686","525","107650","240","109101","0.01"
"2025-09-22T05:29:56.675Z","Included","claude-4-sonnet-thinking","Yes","393","374","107257","360","108384","0.01"
"2025-09-22T05:29:13.305Z","Included","claude-4-sonnet-thinking","Yes","212","375","107045","285","107917","0.01"
"2025-09-22T05:29:07.483Z","Included","claude-4-sonnet-thinking","Yes","184","357","106861","131","107533","0.01"
"2025-09-22T05:29:02.972Z","Included","claude-4-sonnet-thinking","Yes","106","0","106755","110","106971","0.01"
"2025-09-22T05:28:59.238Z","Included","claude-4-sonnet-thinking","Yes","132","381","106623","81","107217","0.01"
"2025-09-22T05:28:55.852Z","Included","claude-4-sonnet-thinking","Yes","123","0","106500","117","106740","0.01"
"2025-09-22T05:28:50.376Z","Errored, Not Charged","claude-4-sonnet-thinking","Yes","196","377","106304","89","106966","0.01"
"2025-09-22T05:28:45.945Z","Included","claude-4-sonnet-thinking","Yes","416","28","105888","148","106480","0.01"
"2025-09-22T05:28:10.452Z","Included","auto","No","96773","90850","2600111","21977","2809711","1.02"
"2025-09-22T05:28:02.322Z","Included","claude-4-sonnet-thinking","Yes","255","386","105633","423","106697","0.01"
"2025-09-22T05:27:56.765Z","Included","claude-4-sonnet-thinking","Yes","1135","391","104498","129","106153","0.01"
"2025-09-22T05:27:52.746Z","Included","claude-4-sonnet-thinking","Yes","0","36","104498","159","104693","0.01"
"2025-09-22T05:27:26.771Z","Errored, Not Charged","claude-4-sonnet-thinking","No","0","391","0","10","401","0.000"
"2025-09-22T05:26:39.709Z","Errored, Not Charged","claude-4-sonnet-thinking","Yes","246","403","104401","130","105180","0.01"
"2025-09-22T05:26:20.555Z","Included","auto","No","438","0","95441","103","95982","0.03"
"2025-09-22T05:25:29.751Z","Included","claude-4-sonnet-thinking","Yes","252","375","104149","232","105008","0.01"
"2025-09-22T05:25:19.117Z","Included","claude-4-sonnet-thinking","Yes","221","398","103928","171","104718","0.01"
"2025-09-22T05:25:11.962Z","Included","claude-4-sonnet-thinking","Yes","591","0","103337","135","104063","0.01"
"2025-09-22T05:24:51.388Z","Included","claude-4-sonnet-thinking","Yes","5950","369","97387","354","104060","0.01"
"2025-09-22T05:24:43.181Z","Included","claude-4-sonnet-thinking","Yes","303","397","97084","144","97928","0.01"
"2025-09-22T05:24:32.197Z","Included","claude-4-sonnet-thinking","Yes","233","398","96851","219","97701","0.01"
"2025-09-22T05:24:21.989Z","Included","claude-4-sonnet-thinking","Yes","653","0","96198","142","96993","0.01"
"2025-09-22T05:24:16.698Z","Included","claude-4-sonnet-thinking","Yes","328","0","95870","368","96566","0.01"
"2025-09-22T05:24:09.680Z","Errored, Not Charged","claude-4-sonnet-thinking","Yes","456","0","95414","122","95992","0.01"
"2025-09-22T05:24:05.027Z","Included","claude-4-sonnet-thinking","Yes","350","0","95064","391","95805","0.01"
"2025-09-22T05:24:00.009Z","Included","claude-4-sonnet-thinking","Yes","547","0","94517","111","95175","0.01"
"2025-09-22T05:23:54.098Z","Included","claude-4-sonnet-thinking","Yes","559","0","93958","127","94644","0.01"
"2025-09-22T05:23:51.217Z","Included","auto","No","471","0","94971","122","95564","0.03"
"2025-09-22T05:23:49.994Z","Included","claude-4-sonnet-thinking","Yes","355","0","93603","306","94264","0.01"
"2025-09-22T05:23:39.105Z","Included","claude-4-sonnet-thinking","Yes","657","0","92946","122","93725","0.01"
"2025-09-22T05:23:29.906Z","Included","claude-4-sonnet-thinking","Yes","336","0","92610","403","93349","0.01"
"2025-09-22T05:23:25.823Z","Included","claude-4-sonnet-thinking","Yes","410","0","92200","111","92721","0.01"
"2025-09-22T05:23:19.317Z","Included","claude-4-sonnet-thinking","Yes","587","0","91613","136","92336","0.01"
"2025-09-22T05:23:12.881Z","Included","claude-4-sonnet-thinking","Yes","452","0","91161","335","91948","0.01"
"2025-09-22T05:22:45.806Z","Included","auto","No","10233","0","343797","234","354264","0.10"
"2025-09-22T05:22:22.727Z","Included","claude-4-sonnet-thinking","Yes","499","390","90662","221","91772","0.01"
"2025-09-22T05:22:12.371Z","Included","claude-4-sonnet-thinking","Yes","633","389","90029","350","91401","0.01"
"2025-09-22T05:22:05.661Z","Included","claude-4-sonnet-thinking","Yes","340","387","89689","150","90566","0.01"
"2025-09-22T05:21:58.551Z","Included","claude-4-sonnet-thinking","Yes","196","2","89493","203","89894","0.01"
"2025-09-22T05:21:54.878Z","Included","claude-4-sonnet-thinking","Yes","452","38","89041","88","89619","0.01"
"2025-09-22T05:19:17.199Z","Included","claude-4-sonnet-thinking","Yes","194","377","88847","459","89877","0.01"
"2025-09-22T05:18:08.645Z","Included","claude-4-sonnet-thinking","Yes","350","378","88497","112","89337","0.01"
"2025-09-22T05:17:21.051Z","Included","auto","No","77616","0","175972","299","253887","0.14"
"2025-09-22T05:17:00.031Z","Included","claude-4-sonnet-thinking","Yes","619","396","87878","113","89006","0.01"
"2025-09-22T05:16:57.318Z","Included","claude-4-sonnet-thinking","Yes","24","2","87854","131","88011","0.01"
"2025-09-22T05:16:32.670Z","Errored, Not Charged","claude-4-sonnet-thinking","No","0","367","0","10","377","0.000"
"2025-09-22T05:15:47.204Z","Errored, Not Charged","claude-4-sonnet-thinking","Yes","213","381","87762","105","88461","0.01"
"2025-09-22T05:15:36.757Z","Included","claude-4-sonnet-thinking","Yes","77251","3","10511","192","87957","0.07"
"2025-09-22T05:14:55.554Z","Errored, Not Charged","claude-4-sonnet-thinking","Yes","0","0","0","0","0","0.00"
"2025-09-22T05:14:42.387Z","Included","claude-4-sonnet-thinking","Yes","391","0","542661","1","543053","0.04"
"2025-09-22T05:14:18.085Z","Included","claude-4-sonnet-thinking","Yes","2281","394","540380","160","543215","0.04"
"2025-09-22T05:12:45.936Z","Included","claude-4-sonnet-thinking","Yes","289","381","540091","236","540997","0.04"
"2025-09-22T05:12:27.988Z","Included","claude-4-sonnet-thinking","Yes","1030","395","539061","149","540635","0.04"
"2025-09-22T05:12:16.747Z","Included","claude-4-sonnet-thinking","Yes","543","0","538518","135","539196","0.04"
"2025-09-22T05:12:04.815Z","Errored, Not Charged","claude-4-sonnet-thinking","Yes","502","0","538016","277","538795","0.04"
"2025-09-22T05:10:48.887Z","Included","claude-4-sonnet-thinking","Yes","294","418","537722","334","538768","0.04"
"2025-09-22T05:09:35.118Z","Included","claude-4-sonnet-thinking","Yes","214","385","537508","208","538315","0.04"
"2025-09-22T05:09:20.477Z","Included","claude-4-sonnet-thinking","Yes","424","531","537084","133","538172","0.04"
"2025-09-22T05:07:48.373Z","Included","claude-4-sonnet-thinking","Yes","290","382","536794","302","537768","0.04"
"2025-09-22T05:07:29.055Z","Included","claude-4-sonnet-thinking","Yes","1030","395","535764","150","537339","0.04"
"2025-09-22T05:07:17.449Z","Included","claude-4-sonnet-thinking","Yes","639","0","535125","135","535899","0.04"
"2025-09-22T05:07:07.818Z","Included","claude-4-sonnet-thinking","Yes","377","0","534748","357","535482","0.04"
"2025-09-22T05:06:57.622Z","Included","claude-4-sonnet-thinking","Yes","466","0","534282","134","534882","0.04"
"2025-09-22T05:05:28.948Z","Included","claude-4-sonnet-thinking","Yes","352","380","533930","197","534859","0.04"
"2025-09-22T05:05:10.113Z","Included","claude-4-sonnet-thinking","Yes","1077","392","532853","212","534534","0.04"
"2025-09-22T05:04:54.008Z","Included","claude-4-sonnet-thinking","Yes","1104","0","531749","189","533042","0.04"
"2025-09-22T05:04:44.683Z","Included","claude-4-sonnet-thinking","Yes","241","0","531508","485","532234","0.04"
"2025-09-22T05:04:35.557Z","Included","claude-4-sonnet-thinking","Yes","180","0","531328","108","531616","0.04"
"2025-09-22T05:04:25.529Z","Included","claude-4-sonnet-thinking","Yes","374","0","530954","109","531437","0.04"
"2025-09-22T05:04:15.230Z","Included","claude-4-sonnet-thinking","Yes","174","0","530780","169","531123","0.04"
"2025-09-22T05:03:49.469Z","Included","claude-4-sonnet-thinking","Yes","2047","393","528733","154","531327","0.04"
"2025-09-22T05:03:36.845Z","Included","claude-4-sonnet-thinking","Yes","669","0","528064","130","528863","0.04"
"2025-09-22T05:03:25.873Z","Included","claude-4-sonnet-thinking","Yes","386","0","527678","384","528448","0.04"
"2025-09-22T05:02:01.373Z","Included","claude-4-sonnet-thinking","Yes","361","418","527317","158","528254","0.04"
"2025-09-22T05:00:29.328Z","Included","claude-4-sonnet-thinking","Yes","285","380","527032","234","527931","0.04"
"2025-09-22T05:00:06.195Z","Included","claude-4-sonnet-thinking","Yes","1619","396","525413","145","527573","0.04"
"2025-09-22T04:59:52.800Z","Included","claude-4-sonnet-thinking","Yes","844","0","524569","134","525547","0.04"
"2025-09-22T04:58:22.591Z","Included","claude-4-sonnet-thinking","Yes","394","382","524175","454","525405","0.04"
"2025-09-22T04:57:57.218Z","Included","claude-4-sonnet-thinking","Yes","1619","396","522556","254","524825","0.04"
"2025-09-22T04:57:44.697Z","Included","claude-4-sonnet-thinking","Yes","795","0","521761","134","522690","0.04"
"2025-09-22T04:57:34.893Z","Included","claude-4-sonnet-thinking","Yes","399","0","521362","389","522150","0.04"
"2025-09-22T04:57:10.102Z","Included","claude-4-sonnet-thinking","Yes","5864","398","515498","214","521974","0.04"
"2025-09-22T04:56:44.256Z","Included","auto","No","74620","0","7128","459","82207","0.10"
"2025-09-22T04:55:47.640Z","Included","claude-4-sonnet-thinking","Yes","331","423","515167","146","516067","0.04"
"2025-09-22T04:55:39.412Z","Included","claude-4-sonnet-thinking","Yes","504656","14","10511","154","515335","0.46"
"2025-09-22T04:41:48.921Z","Included","claude-4-sonnet-thinking","Yes","585","570","514396","193","515744","0.04"
"2025-09-22T04:40:21.177Z","Included","claude-4-sonnet-thinking","Yes","412","381","513984","463","515240","0.04"
"2025-09-22T04:40:00.903Z","Included","claude-4-sonnet-thinking","Yes","5002","393","508982","272","514649","0.04"
"2025-09-22T04:39:49.652Z","Included","claude-4-sonnet-thinking","Yes","749","0","508233","131","509113","0.04"
"2025-09-22T04:39:37.261Z","Included","claude-4-sonnet-thinking","Yes","434","0","507799","481","508714","0.04"
"2025-09-22T04:39:22.236Z","Included","claude-4-sonnet-thinking","Yes","605","542","507194","206","508547","0.04"
"2025-09-22T04:39:00.217Z","Included","claude-4-sonnet-thinking","Yes","9008","398","498186","481","508073","0.05"
"2025-09-22T04:37:37.187Z","Included","claude-4-sonnet-thinking","Yes","305","385","497881","216","498787","0.04"
"2025-09-22T04:37:20.929Z","Included","claude-4-sonnet-thinking","Yes","680","378","497201","165","498424","0.04"
"2025-09-22T04:37:11.315Z","Included","claude-4-sonnet-thinking","Yes","388","0","496813","117","497318","0.04"
"2025-09-22T04:36:54.975Z","Included","claude-4-sonnet-thinking","Yes","4960","390","491853","207","497410","0.04"
"2025-09-22T04:36:45.895Z","Included","claude-4-sonnet-thinking","Yes","334","0","491519","130","491983","0.04"
"2025-09-22T04:36:29.457Z","Included","claude-4-sonnet-thinking","Yes","9049","394","482470","245","492158","0.04"
"2025-09-22T04:36:19.665Z","Included","claude-4-sonnet-thinking","Yes","400","0","482070","135","482605","0.04"
"2025-09-22T04:36:11.112Z","Included","claude-4-sonnet-thinking","Yes","260","0","481810","202","482272","0.04"
"2025-09-22T04:35:56.085Z","Included","claude-4-sonnet-thinking","Yes","4871","382","476939","124","482316","0.04"
"2025-09-22T04:35:43.896Z","Included","claude-4-sonnet-thinking","Yes","309","393","476630","148","477480","0.04"
"2025-09-22T04:35:31.649Z","Included","claude-4-sonnet-thinking","Yes","297","391","476333","196","477217","0.04"
"2025-09-22T04:34:07.739Z","Included","claude-4-sonnet-thinking","Yes","309","384","476024","216","476933","0.04"
"2025-09-22T04:33:51.259Z","Included","claude-4-sonnet-thinking","Yes","680","379","475344","163","476566","0.04"
"2025-09-22T04:33:40.870Z","Included","claude-4-sonnet-thinking","Yes","603","0","474741","119","475463","0.04"
"2025-09-22T04:33:22.184Z","Included","claude-4-sonnet-thinking","Yes","4894","381","469847","380","475502","0.04"
"2025-09-22T04:33:12.842Z","Included","claude-4-sonnet-thinking","Yes","462","0","469385","119","469966","0.03"
"2025-09-22T04:33:05.067Z","Included","claude-4-sonnet-thinking","Yes","334","0","469051","227","469612","0.03"
"2025-09-22T04:32:57.218Z","Included","claude-4-sonnet-thinking","Yes","7","20","469044","145","469216","0.03"
"2025-09-22T04:32:17.297Z","Errored, Not Charged","claude-4-sonnet-thinking","Yes","0","0","0","0","0","0.00"
"2025-09-22T04:31:58.902Z","Included","claude-4-sonnet-thinking","Yes","4946","381","464098","137","469562","0.04"
"2025-09-22T04:31:42.582Z","Included","claude-4-sonnet-thinking","Yes","682","379","463416","163","464640","0.03"
"2025-09-22T04:31:33.659Z","Included","claude-4-sonnet-thinking","Yes","489","0","462927","119","463535","0.03"
"2025-09-22T04:31:14.644Z","Included","claude-4-sonnet-thinking","Yes","4487","384","458440","316","463627","0.04"
"2025-09-22T04:31:03.995Z","Included","claude-4-sonnet-thinking","Yes","658","0","457782","122","458562","0.03"
"2025-09-22T04:30:56.208Z","Included","claude-4-sonnet-thinking","Yes","289","0","457493","342","458124","0.03"
"2025-09-22T04:30:40.326Z","Included","claude-4-sonnet-thinking","Yes","5001","384","452492","147","458024","0.04"
"2025-09-22T04:30:21.765Z","Included","claude-4-sonnet-thinking","Yes","689","386","451803","230","453108","0.03"
"2025-09-22T04:30:11.276Z","Included","claude-4-sonnet-thinking","Yes","617","0","451186","124","451927","0.03"
"2025-09-22T04:30:03.140Z","Included","claude-4-sonnet-thinking","Yes","398","0","450788","334","451520","0.03"
"2025-09-22T04:29:44.947Z","Included","claude-4-sonnet-thinking","Yes","5010","386","445778","234","451408","0.04"
"2025-09-22T04:29:34.794Z","Included","claude-4-sonnet-thinking","Yes","364","396","445414","139","446313","0.03"
"2025-09-22T04:29:23.497Z","Included","claude-4-sonnet-thinking","Yes","354","391","445060","201","446006","0.03"
"2025-09-22T04:28:00.954Z","Included","claude-4-sonnet-thinking","Yes","293","383","444767","224","445667","0.03"
"2025-09-22T04:26:43.932Z","Included","claude-4-sonnet-thinking","Yes","319","386","444448","133","445286","0.03"
"2025-09-22T04:26:30.097Z","Included","claude-4-sonnet-thinking","Yes","433937","17","10511","126","444591","0.39"
"2025-09-22T03:24:05.982Z","Included","claude-4-sonnet-thinking","Yes","421","496","443822","212","444951","0.03"
"2025-09-22T03:23:54.292Z","Included","claude-4-sonnet-thinking","Yes","1937","361","441885","305","444488","0.03"
"2025-09-22T03:23:35.044Z","Included","claude-4-sonnet-thinking","Yes","8935","395","432950","205","442485","0.04"
"2025-09-22T03:23:23.977Z","Included","claude-4-sonnet-thinking","Yes","826","0","432124","133","433083","0.03"
"2025-09-22T03:23:06.094Z","Included","claude-4-sonnet-thinking","Yes","8851","398","423273","464","432986","0.04"
"2025-09-22T03:22:59.002Z","Included","claude-4-sonnet-thinking","Yes","247","0","423026","165","423438","0.03"
"2025-09-22T03:22:49.920Z","Included","claude-4-sonnet-thinking","Yes","198","0","422828","109","423135","0.03"
"2025-09-22T03:22:39.225Z","Included","claude-4-sonnet-thinking","Yes","768","0","422060","128","422956","0.03"
"2025-09-22T03:22:21.212Z","Included","claude-4-sonnet-thinking","Yes","8887","396","413173","412","422868","0.04"
"2025-09-22T03:21:58.039Z","Included","claude-4-sonnet-thinking","Yes","1572","385","411601","211","413769","0.03"
"2025-09-22T03:21:47.250Z","Included","claude-4-sonnet-thinking","Yes","724","0","410877","138","411739","0.03"
"2025-09-22T03:21:38.119Z","Errored, Not Charged","claude-4-sonnet-thinking","Yes","392","0","410485","379","411256","0.03"
"2025-09-22T03:21:27.284Z","Included","claude-4-sonnet-thinking","Yes","729","0","409756","334","410819","0.03"
"2025-09-22T03:21:17.287Z","Included","claude-4-sonnet-thinking","Yes","725","0","409031","390","410146","0.03"
"2025-09-22T03:20:49.063Z","Included","claude-4-sonnet-thinking","Yes","3523","0","405508","431","409462","0.03"
"2025-09-22T03:20:40.551Z","Included","claude-4-sonnet-thinking","Yes","75","110","405433","1775","407393","0.04"
"2025-09-22T03:20:01.918Z","Errored, Not Charged","claude-4-sonnet-thinking","Yes","0","0","0","0","0","0.00"
"2025-09-22T03:19:46.532Z","Included","claude-4-sonnet-thinking","Yes","300","396","405133","11","405840","0.03"
"2025-09-22T03:18:28.826Z","Included","claude-4-sonnet-thinking","Yes","365","382","404768","224","405739","0.03"
"2025-09-22T03:18:05.981Z","Included","claude-4-sonnet-thinking","Yes","1560","385","403208","225","405378","0.03"
"2025-09-22T03:17:57.002Z","Included","claude-4-sonnet-thinking","Yes","580","0","402628","126","403334","0.03"
"2025-09-22T03:17:33.435Z","Included","claude-4-sonnet-thinking","Yes","5742","386","396886","370","403384","0.03"
"2025-09-22T03:17:18.859Z","Included","claude-4-sonnet-thinking","Yes","1590","0","395296","155","397041","0.03"
"2025-09-22T03:17:17.705Z","Included","auto","No","74055","0","873679","1814","949548","0.32"
"2025-09-22T03:17:11.670Z","Included","claude-4-sonnet-thinking","Yes","567","0","394729","823","396119","0.03"
"2025-09-22T03:16:55.874Z","Errored, Not Charged","claude-4-sonnet-thinking","Yes","1063","0","393666","121","394850","0.03"
"2025-09-22T03:16:47.295Z","Included","claude-4-sonnet-thinking","Yes","751","0","392915","998","394664","0.03"
"2025-09-22T03:16:38.003Z","Included","claude-4-sonnet-thinking","Yes","18","36","392897","269","393220","0.03"
"2025-09-22T03:15:54.967Z","Errored, Not Charged","claude-4-sonnet-thinking","Yes","0","0","0","0","0","0.00"
"2025-09-22T03:15:33.854Z","Included","claude-4-sonnet-thinking","Yes","2278","392","390619","134","393423","0.03"
"2025-09-22T03:14:31.476Z","Included","claude-4-sonnet-thinking","Yes","290","381","390329","207","391207","0.03"
"2025-09-22T03:14:16.591Z","Included","claude-4-sonnet-thinking","Yes","1026","393","389303","150","390872","0.03"
"2025-09-22T03:14:05.482Z","Included","claude-4-sonnet-thinking","Yes","750","0","388553","131","389434","0.03"
"2025-09-22T03:13:44.502Z","Included","claude-4-sonnet-thinking","Yes","1600","392","386953","442","389387","0.03"
"2025-09-22T03:13:34.271Z","Included","claude-4-sonnet-thinking","Yes","783","0","386170","130","387083","0.03"
"2025-09-22T03:13:25.867Z","Included","claude-4-sonnet-thinking","Yes","362","0","385808","471","386641","0.03"
"2025-09-22T03:13:18.085Z","Included","claude-4-sonnet-thinking","Yes","303","0","385505","135","385943","0.03"
"2025-09-22T03:12:27.665Z","Included","claude-4-sonnet-thinking","Yes","328","410","385177","138","386053","0.03"
"2025-09-22T03:11:38.212Z","Included","claude-4-sonnet-thinking","Yes","226","422","384951","153","385752","0.03"
"2025-09-22T03:11:28.167Z","Included","claude-4-sonnet-thinking","Yes","373","472","384578","162","385585","0.03"
"2025-09-22T03:10:16.472Z","Included","claude-4-sonnet-thinking","Yes","289","381","384289","260","385219","0.03"
"2025-09-22T03:10:01.661Z","Included","claude-4-sonnet-thinking","Yes","1002","384","383287","149","384822","0.03"
"2025-09-22T03:09:52.152Z","Included","claude-4-sonnet-thinking","Yes","658","0","382629","123","383410","0.03"
"2025-09-22T03:09:35.950Z","Included","claude-4-sonnet-thinking","Yes","4996","386","377633","403","383418","0.03"
"2025-09-22T03:09:26.343Z","Included","claude-4-sonnet-thinking","Yes","704","0","376929","124","377757","0.03"
"2025-09-22T03:09:08.528Z","Included","claude-4-sonnet-thinking","Yes","9022","381","367907","443","377753","0.04"
"2025-09-22T03:08:03.626Z","Included","claude-4-sonnet-thinking","Yes","288","380","367619","174","368461","0.03"
"2025-09-22T03:07:49.369Z","Included","claude-4-sonnet-thinking","Yes","1024","389","366595","148","368156","0.03"
"2025-09-22T03:07:42.823Z","Included","claude-4-sonnet-thinking","Yes","435","0","366160","130","366725","0.03"
"2025-09-22T03:07:34.057Z","Included","claude-4-sonnet-thinking","Yes","481","0","365679","227","366387","0.03"
"2025-09-22T03:07:18.240Z","Included","claude-4-sonnet-thinking","Yes","8751","389","356928","289","366357","0.03"
"2025-09-22T03:07:10.117Z","Included","claude-4-sonnet-thinking","Yes","477","0","356451","130","357058","0.03"
"2025-09-22T03:07:02.122Z","Included","claude-4-sonnet-thinking","Yes","531","0","355920","267","356718","0.03"
"2025-09-22T03:06:46.667Z","Included","claude-4-sonnet-thinking","Yes","8984","388","346936","337","356645","0.03"
"2025-09-22T03:05:36.345Z","Included","claude-4-sonnet-thinking","Yes","290","381","346646","181","347498","0.03"
"2025-09-22T03:05:21.805Z","Included","claude-4-sonnet-thinking","Yes","1006","385","345640","150","347181","0.03"
"2025-09-22T03:05:11.706Z","Included","claude-4-sonnet-thinking","Yes","705","0","344935","125","345765","0.03"
"2025-09-22T03:04:56.837Z","Included","claude-4-sonnet-thinking","Yes","1534","383","343401","408","345726","0.03"
"2025-09-22T03:04:46.500Z","Included","claude-4-sonnet-thinking","Yes","722","0","342679","123","343524","0.03"
"2025-09-22T03:04:32.617Z","Included","claude-4-sonnet-thinking","Yes","954","0","341725","420","343099","0.03"
"2025-09-22T03:04:21.964Z","Included","claude-4-sonnet-thinking","Yes","311","397","341414","757","342879","0.03"
"2025-09-22T03:04:10.826Z","Included","claude-4-sonnet-thinking","Yes","278","397","341136","200","342011","0.03"
"2025-09-22T03:02:35.657Z","Included","claude-4-sonnet-thinking","Yes","297","383","340839","197","341716","0.03"
"2025-09-22T03:02:14.418Z","Included","claude-4-sonnet-thinking","Yes","1578","383","339261","157","341379","0.03"
"2025-09-22T03:02:00.067Z","Included","claude-4-sonnet-thinking","Yes","1756","0","337505","144","339405","0.03"
"2025-09-22T03:01:53.141Z","Included","claude-4-sonnet-thinking","Yes","608","0","336897","796","338301","0.03"
"2025-09-22T03:01:45.986Z","Included","claude-4-sonnet-thinking","Yes","673","0","336224","162","337059","0.03"
"2025-09-22T03:01:39.864Z","Included","claude-4-sonnet-thinking","Yes","124","0","336100","128","336352","0.02"
"2025-09-22T03:01:34.445Z","Included","claude-4-sonnet-thinking","Yes","121","0","335979","94","336194","0.02"
"2025-09-22T03:01:27.517Z","Included","claude-4-sonnet-thinking","Yes","230","0","335749","91","336070","0.02"
"2025-09-22T03:01:19.266Z","Included","claude-4-sonnet-thinking","Yes","475","0","335274","196","335945","0.03"
"2025-09-22T03:01:00.783Z","Included","claude-4-sonnet-thinking","Yes","2024","386","333250","289","335949","0.03"
"2025-09-22T03:00:10.421Z","Included","claude-4-sonnet-thinking","Yes","394","420","332856","136","333806","0.02"
"2025-09-22T02:59:11.780Z","Included","claude-4-sonnet-thinking","Yes","272","382","332584","227","333465","0.02"
"2025-09-22T02:59:03.964Z","Included","claude-4-sonnet-thinking","Yes","234","379","332350","132","333095","0.02"
"2025-09-22T02:58:58.238Z","Included","claude-4-sonnet-thinking","Yes","105","26","332245","118","332494","0.02"
"2025-09-22T02:56:00.987Z","Included","claude-4-sonnet-thinking","Yes","288","23","331957","79","332347","0.02"
"2025-09-22T02:55:10.795Z","Included","claude-4-sonnet-thinking","Yes","448","18","331509","267","332242","0.03"
"2025-09-22T02:54:10.102Z","Included","claude-4-sonnet-thinking","Yes","522","620","330987","455","332584","0.03"
"2025-09-22T02:54:04.334Z","Included","claude-4-sonnet-thinking","Yes","444","28","330543","384","331399","0.03"
"2025-09-22T02:53:04.857Z","Included","claude-4-sonnet-thinking","Yes","831","893","329712","484","331920","0.03"
"2025-09-22T02:52:56.742Z","Included","claude-4-sonnet-thinking","Yes","269","373","329443","731","330816","0.03"
"2025-09-22T02:52:49.418Z","Included","claude-4-sonnet-thinking","Yes","993","18","328450","140","329601","0.03"
"2025-09-22T02:51:24.166Z","Included","claude-4-sonnet-thinking","Yes","1048","1146","327402","1000","330596","0.03"
"2025-09-22T02:51:11.376Z","Included","claude-4-sonnet-thinking","Yes","1206","508","326196","994","328904","0.03"
"2025-09-22T02:50:47.951Z","Included","claude-4-sonnet-thinking","Yes","1018","1143","325178","285","327624","0.03"
"2025-09-22T02:50:35.099Z","Included","claude-4-sonnet-thinking","Yes","645","3913","324533","1418","330509","0.03"
"2025-09-22T02:50:29.811Z","Included","claude-4-sonnet-thinking","Yes","350","20","324183","94","324647","0.02"
"2025-09-22T02:49:49.088Z","Included","claude-4-sonnet-thinking","Yes","501","370","323682","357","324910","0.03"
"2025-09-22T02:49:43.976Z","Included","claude-4-sonnet-thinking","Yes","325","57","323357","109","323848","0.02"
"2025-09-22T02:46:12.496Z","Included","claude-4-sonnet-thinking","Yes","399","469","322958","332","324158","0.02"
"2025-09-22T02:45:11.155Z","Included","claude-4-sonnet-thinking","Yes","294","382","322664","282","323622","0.02"
"2025-09-22T02:45:04.845Z","Included","claude-4-sonnet-thinking","Yes","142","0","322522","144","322808","0.02"
"2025-09-22T02:44:56.042Z","Included","claude-4-sonnet-thinking","Yes","1855","364","320667","117","323003","0.03"
"2025-09-22T02:44:46.692Z","Included","claude-4-sonnet-thinking","Yes","524","0","320143","116","320783","0.02"
"2025-09-22T02:44:39.866Z","Included","claude-4-sonnet-thinking","Yes","449","0","319694","278","320421","0.02"
"2025-09-22T02:44:33.244Z","Included","claude-4-sonnet-thinking","Yes","410","0","319284","133","319827","0.02"
"2025-09-22T02:44:25.347Z","Included","claude-4-sonnet-thinking","Yes","380","0","318904","303","319587","0.02"
"2025-09-22T02:44:18.596Z","Included","claude-4-sonnet-thinking","Yes","242","0","318662","143","319047","0.02"
"2025-09-22T02:44:11.624Z","Included","claude-4-sonnet-thinking","Yes","289","0","318373","143","318805","0.02"
"2025-09-22T02:44:02.068Z","Included","claude-4-sonnet-thinking","Yes","704","0","317669","112","318485","0.02"
"2025-09-22T02:43:56.730Z","Included","claude-4-sonnet-thinking","Yes","57","25","317612","359","318053","0.02"
"2025-09-22T02:43:17.261Z","Errored, Not Charged","claude-4-sonnet-thinking","Yes","0","0","0","0","0","0.00"
"2025-09-22T02:42:59.600Z","Included","claude-4-sonnet-thinking","Yes","2062","386","315550","173","318171","0.03"
"2025-09-22T02:42:52.791Z","Included","claude-4-sonnet-thinking","Yes","119","0","315431","164","315714","0.02"
"2025-09-22T02:42:45.942Z","Included","claude-4-sonnet-thinking","Yes","150","0","315281","89","315520","0.02"
"2025-09-22T02:42:39.736Z","Included","claude-4-sonnet-thinking","Yes","171","0","315110","120","315401","0.02"
"2025-09-22T02:42:33.023Z","Included","claude-4-sonnet-thinking","Yes","448","0","314662","141","315251","0.02"
"2025-09-22T02:42:20.923Z","Included","claude-4-sonnet-thinking","Yes","390","467","314272","116","315245","0.02"
"2025-09-22T02:41:22.199Z","Included","claude-4-sonnet-thinking","Yes","307","384","313965","271","314927","0.02"
"2025-09-22T02:41:12.356Z","Included","claude-4-sonnet-thinking","Yes","1849","364","312116","161","314490","0.02"
"2025-09-22T02:41:03.195Z","Included","claude-4-sonnet-thinking","Yes","463","0","311653","119","312235","0.02"
"2025-09-22T02:40:52.501Z","Included","claude-4-sonnet-thinking","Yes","1066","0","310587","259","311912","0.02"
"2025-09-22T02:40:44.424Z","Included","claude-4-sonnet-thinking","Yes","426","0","310161","593","311180","0.02"
"2025-09-22T02:40:39.142Z","Included","claude-4-sonnet-thinking","Yes","177","0","309984","134","310295","0.02"
"2025-09-22T02:40:29.321Z","Included","claude-4-sonnet-thinking","Yes","476","0","309508","147","310131","0.02"
"2025-09-22T02:40:21.428Z","Included","claude-4-sonnet-thinking","Yes","202","371","309306","140","310019","0.02"
"2025-09-22T02:40:15.003Z","Included","claude-4-sonnet-thinking","Yes","282","374","309024","119","309799","0.02"
"2025-09-22T02:40:08.726Z","Included","claude-4-sonnet-thinking","Yes","180","366","308844","148","309538","0.02"
"2025-09-22T02:39:58.505Z","Included","claude-4-sonnet-thinking","Yes","2211","380","306633","116","309340","0.02"
"2025-09-22T02:39:51.283Z","Included","claude-4-sonnet-thinking","Yes","227","406","306406","125","307164","0.02"
"2025-09-22T02:39:44.188Z","Included","claude-4-sonnet-thinking","Yes","821","408","305585","146","306960","0.02"
"2025-09-22T02:39:38.994Z","Included","claude-4-sonnet-thinking","Yes","28","68","305557","139","305792","0.02"
"2025-09-22T02:38:55.492Z","Errored, Not Charged","claude-4-sonnet-thinking","Yes","0","0","0","0","0","0.00"
"2025-09-22T02:38:49.300Z","Included","claude-4-sonnet-thinking","Yes","180","364","305377","365","306286","0.02"
"2025-09-22T02:38:42.303Z","Included","claude-4-sonnet-thinking","Yes","416","403","304961","116","305896","0.02"
"2025-09-22T02:38:34.348Z","Included","claude-4-sonnet-thinking","Yes","410","399","304551","144","305504","0.02"
"2025-09-22T02:38:27.133Z","Included","claude-4-sonnet-thinking","Yes","89","51","304462","171","304773","0.02"
"2025-09-22T02:37:50.578Z","Errored, Not Charged","claude-4-sonnet-thinking","No","0","403","0","10","413","0.000"
"2025-09-22T02:37:40.698Z","Included","claude-4-sonnet-thinking","Yes","0","55","304462","171","304688","0.02"
"2025-09-22T02:37:17.085Z","Errored, Not Charged","claude-4-sonnet-thinking","Yes","0","0","0","0","0","0.00"
"2025-09-22T02:37:01.881Z","Errored, Not Charged","claude-4-sonnet-thinking","Yes","135","0","304462","1","304598","0.02"
"2025-09-22T02:36:56.434Z","Included","claude-4-sonnet-thinking","Yes","311","0","304151","111","304573","0.02"
"2025-09-22T02:36:51.572Z","Included","claude-4-sonnet-thinking","Yes","117","0","304034","126","304277","0.02"
"2025-09-22T02:36:43.010Z","Included","claude-4-sonnet-thinking","Yes","266","0","303768","87","304121","0.02"
"2025-09-22T02:36:36.041Z","Included","claude-4-sonnet-thinking","Yes","477","0","303291","232","304000","0.02"
"2025-09-22T02:36:29.301Z","Included","claude-4-sonnet-thinking","Yes","757","0","302534","166","303457","0.02"
"2025-09-22T02:36:13.864Z","Included","claude-4-sonnet-thinking","Yes","2786","0","299748","161","302695","0.02"
"2025-09-22T02:36:08.566Z","Included","claude-4-sonnet-thinking","Yes","328","0","299420","107","299855","0.02"
"2025-09-22T02:36:02.979Z","Included","claude-4-sonnet-thinking","Yes","8","22","299412","144","299586","0.02"
"2025-09-22T02:35:27.703Z","Errored, Not Charged","claude-4-sonnet-thinking","Yes","0","0","0","0","0","0.00"
"2025-09-22T02:35:18.029Z","Included","claude-4-sonnet-thinking","Yes","588","0","298824","116","299528","0.02"
"2025-09-22T02:35:02.811Z","Included","claude-4-sonnet-thinking","Yes","1307","0","297517","139","298963","0.02"
"2025-09-22T02:34:57.160Z","Included","claude-4-sonnet-thinking","Yes","7","69","297510","763","298349","0.02"
"2025-09-22T02:34:20.280Z","Errored, Not Charged","claude-4-sonnet-thinking","No","0","396","0","10","406","0.000"
"2025-09-22T02:34:10.927Z","Included","claude-4-sonnet-thinking","Yes","734","0","296776","148","297658","0.02"
"2025-09-22T02:32:46.221Z","Included","claude-4-sonnet-thinking","Yes","287","379","296489","216","297371","0.02"
"2025-09-22T02:32:32.434Z","Included","claude-4-sonnet-thinking","Yes","1027","394","295462","147","297030","0.02"
"2025-09-22T02:32:23.460Z","Included","claude-4-sonnet-thinking","Yes","838","0","294624","132","295594","0.02"
"2025-09-22T02:32:07.826Z","Included","claude-4-sonnet-thinking","Yes","8866","394","285758","468","295486","0.03"
"2025-09-22T02:31:56.487Z","Included","claude-4-sonnet-thinking","Yes","1358","0","284400","132","285890","0.02"
"2025-09-22T02:31:50.274Z","Included","claude-4-sonnet-thinking","Yes","393","0","284007","705","285105","0.02"
"2025-09-22T02:31:30.708Z","Included","claude-4-sonnet-thinking","Yes","2126","395","281881","145","284547","0.02"
"2025-09-22T02:30:04.641Z","Included","claude-4-sonnet-thinking","Yes","293","379","281588","172","282432","0.02"
"2025-09-22T02:29:44.544Z","Included","claude-4-sonnet-thinking","Yes","1617","394","279971","153","282135","0.02"
"2025-09-22T02:29:35.835Z","Included","claude-4-sonnet-thinking","Yes","714","0","279257","132","280103","0.02"
"2025-09-22T02:29:30.193Z","Included","claude-4-sonnet-thinking","Yes","471","0","278786","378","279635","0.02"
"2025-09-22T02:29:10.330Z","Included","claude-4-sonnet-thinking","Yes","2152","397","276634","133","279316","0.02"
"2025-09-22T02:27:51.569Z","Included","claude-4-sonnet-thinking","Yes","246","411","276388","167","277212","0.02"
"2025-09-22T02:26:31.288Z","Included","claude-4-sonnet-thinking","Yes","276","419","276112","179","276986","0.02"
"2025-09-22T02:24:50.601Z","Included","claude-4-sonnet-thinking","Yes","288","381","275824","189","276682","0.02"
"2025-09-22T02:24:46.391Z","Included","claude-4-sonnet-thinking","Yes","0","16","275824","121","275961","0.02"
"2025-09-22T02:24:23.992Z","Errored, Not Charged","claude-4-sonnet-thinking","No","0","385","0","10","395","0.000"
"2025-09-22T02:23:20.429Z","Included","auto","No","16007","0","2161877","3610","2181494","0.58"
"2025-09-22T02:23:05.428Z","Errored, Not Charged","claude-4-sonnet-thinking","Yes","164","381","275801","133","276479","0.02"
"2025-09-22T02:22:52.278Z","Included","claude-4-sonnet-thinking","Yes","1027","391","274774","150","276342","0.02"
"2025-09-22T02:22:44.981Z","Included","claude-4-sonnet-thinking","Yes","601","0","274173","136","274910","0.02"
"2025-09-22T02:22:29.982Z","Included","claude-4-sonnet-thinking","Yes","5288","390","268885","345","274908","0.03"
"2025-09-22T02:22:24.369Z","Included","auto","No","979","3922","179351","627","184879","0.05"
"2025-09-22T02:22:19.687Z","Errored, Not Charged","auto","No","2155","0","57251","139","59545","0.02"
"2025-09-22T02:21:58.115Z","Errored, Not Charged","auto","No","50128","0","232710","654","283492","0.12"
"2025-09-22T02:21:10.514Z","Included","claude-4-sonnet-thinking","Yes","266","422","268619","144","269451","0.02"
"2025-09-22T02:21:06.006Z","Included","claude-4-sonnet-thinking","Yes","258108","16","10511","152","268787","0.23"
"2025-09-22T02:14:17.029Z","Included","claude-4-sonnet-thinking","Yes","310","386","267840","476","269012","0.02"
"2025-09-22T02:14:03.416Z","Included","claude-4-sonnet-thinking","Yes","1003","386","266837","170","268396","0.02"
"2025-09-22T02:13:56.263Z","Included","claude-4-sonnet-thinking","Yes","609","0","266228","124","266961","0.02"
"2025-09-22T02:13:47.722Z","Included","claude-4-sonnet-thinking","Yes","323","0","265905","322","266550","0.02"
"2025-09-22T02:13:33.646Z","Included","claude-4-sonnet-thinking","Yes","5226","385","260679","162","266452","0.02"
"2025-09-22T02:13:25.442Z","Included","claude-4-sonnet-thinking","Yes","742","0","259937","123","260802","0.02"
"2025-09-22T02:13:10.120Z","Included","claude-4-sonnet-thinking","Yes","9277","386","250660","406","260729","0.03"
"2025-09-22T02:11:35.852Z","Included","claude-4-sonnet-thinking","Yes","305","381","250355","217","251258","0.02"
"2025-09-22T02:11:21.727Z","Included","claude-4-sonnet-thinking","Yes","1022","387","249333","165","250907","0.02"
"2025-09-22T02:11:14.422Z","Included","claude-4-sonnet-thinking","Yes","656","0","248677","128","249461","0.02"
"2025-09-22T02:11:00.074Z","Included","claude-4-sonnet-thinking","Yes","9009","392","239668","350","249419","0.03"
"2025-09-22T02:09:26.215Z","Included","claude-4-sonnet-thinking","Yes","308","381","239360","210","240259","0.02"
"2025-09-22T02:09:13.770Z","Included","claude-4-sonnet-thinking","Yes","1003","387","238357","168","239915","0.02"
"2025-09-22T02:09:08.189Z","Included","claude-4-sonnet-thinking","Yes","502","0","237855","123","238480","0.02"
"2025-09-22T02:09:02.704Z","Included","claude-4-sonnet-thinking","Yes","390","0","237465","208","238063","0.02"
"2025-09-22T02:08:48.777Z","Included","claude-4-sonnet-thinking","Yes","4704","388","232761","190","238043","0.02"
"2025-09-22T02:07:14.661Z","Included","claude-4-sonnet-thinking","Yes","321","381","232440","202","233344","0.02"
"2025-09-22T02:06:59.806Z","Included","claude-4-sonnet-thinking","Yes","1026","392","231414","181","233013","0.02"
"2025-09-22T02:06:52.888Z","Included","claude-4-sonnet-thinking","Yes","599","0","230815","134","231548","0.02"
"2025-09-22T02:06:48.593Z","Included","claude-4-sonnet-thinking","Yes","349","0","230466","304","231119","0.02"
"2025-09-22T02:06:40.599Z","Errored, Not Charged","claude-4-sonnet-thinking","Yes","338","0","230128","130","230596","0.02"
"2025-09-22T02:06:25.977Z","Included","claude-4-sonnet-thinking","Yes","4734","389","225394","220","230737","0.02"
"2025-09-22T02:06:19.202Z","Included","claude-4-sonnet-thinking","Yes","466","0","224928","130","225524","0.02"
"2025-09-22T02:06:14.857Z","Included","claude-4-sonnet-thinking","Yes","273","0","224655","230","225158","0.02"
"2025-09-22T02:06:09.972Z","Included","claude-4-sonnet-thinking","Yes","141","0","224514","107","224762","0.02"
"2025-09-22T02:06:05.598Z","Included","claude-4-sonnet-thinking","Yes","172","0","224342","107","224621","0.02"
"2025-09-22T02:05:59.874Z","Included","claude-4-sonnet-thinking","Yes","372","0","223970","142","224484","0.02"
"2025-09-22T02:05:52.236Z","Errored, Not Charged","claude-4-sonnet-thinking","Yes","358","0","223612","120","224090","0.02"
"2025-09-22T02:05:37.854Z","Included","claude-4-sonnet-thinking","Yes","7774","388","215838","240","224240","0.02"
"2025-09-22T02:05:30.961Z","Included","claude-4-sonnet-thinking","Yes","553","0","215285","129","215967","0.02"
"2025-09-22T02:05:23.762Z","Errored, Not Charged","claude-4-sonnet-thinking","Yes","287","0","214998","256","215541","0.02"
"2025-09-22T02:05:18.196Z","Included","claude-4-sonnet-thinking","Yes","440","0","214558","208","215206","0.02"
"2025-09-22T02:05:01.101Z","Included","claude-4-sonnet-thinking","Yes","7828","391","206730","211","215160","0.02"
"2025-09-22T02:03:40.394Z","Included","claude-4-sonnet-thinking","Yes","248","390","206482","191","207311","0.02"
"2025-09-22T02:02:03.476Z","Included","claude-4-sonnet-thinking","Yes","339","381","206143","167","207030","0.02"
"2025-09-22T02:01:43.511Z","Included","claude-4-sonnet-thinking","Yes","1560","386","204583","199","206728","0.02"
"2025-09-22T02:01:37.464Z","Included","claude-4-sonnet-thinking","Yes","499","0","204084","126","204709","0.02"
"2025-09-22T02:01:17.801Z","Included","claude-4-sonnet-thinking","Yes","5818","386","198266","277","204747","0.02"
"2025-09-22T02:01:10.389Z","Included","claude-4-sonnet-thinking","Yes","565","0","197701","127","198393","0.02"
"2025-09-22T02:01:05.145Z","Included","claude-4-sonnet-thinking","Yes","265","0","197436","298","197999","0.02"
"2025-09-22T02:00:59.406Z","Errored, Not Charged","claude-4-sonnet-thinking","Yes","379","0","197057","111","197547","0.01"
"2025-09-22T02:00:51.796Z","Included","claude-4-sonnet-thinking","Yes","418","0","196639","300","197357","0.02"
"2025-09-22T02:00:31.618Z","Included","claude-4-sonnet-thinking","Yes","2030","384","194609","174","197197","0.02"
"2025-09-22T02:00:15.333Z","Included","claude-4-sonnet-thinking","Yes","1946","0","192663","124","194733","0.02"
"2025-09-22T02:00:08.946Z","Included","claude-4-sonnet-thinking","Yes","554","0","192109","1061","193724","0.02"
"2025-09-22T02:00:04.433Z","Included","claude-4-sonnet-thinking","Yes","199","0","191910","109","192218","0.01"
"2025-09-22T01:59:59.276Z","Included","claude-4-sonnet-thinking","Yes","398","0","191512","107","192017","0.01"
"2025-09-22T01:59:54.290Z","Included","claude-4-sonnet-thinking","Yes","420","0","191092","154","191666","0.01"
"2025-09-22T01:59:39.679Z","Included","claude-4-sonnet-thinking","Yes","2062","385","189030","195","191672","0.02"
"2025-09-22T01:58:57.730Z","Included","claude-4-sonnet-thinking","Yes","365","423","188665","176","189629","0.01"
"2025-09-22T01:58:54.126Z","Included","claude-4-sonnet-thinking","Yes","178154","13","10511","176","188854","0.16"
"2025-09-22T01:42:37.057Z","Included","claude-4-sonnet-thinking","Yes","313","383","187788","571","189055","0.02"
"2025-09-22T01:42:21.162Z","Included","claude-4-sonnet-thinking","Yes","1022","396","186766","173","188357","0.01"
"2025-09-22T01:42:12.819Z","Included","claude-4-sonnet-thinking","Yes","824","0","185942","134","186900","0.01"
"2025-09-22T01:42:08.413Z","Included","claude-4-sonnet-thinking","Yes","502","0","185440","363","186305","0.02"
"2025-09-22T01:42:02.995Z","Included","claude-4-sonnet-thinking","Yes","154","0","185286","183","185623","0.01"
"2025-09-22T01:41:59.056Z","Included","claude-4-sonnet-thinking","Yes","121","0","185165","91","185377","0.01"
"2025-09-22T01:41:54.124Z","Included","claude-4-sonnet-thinking","Yes","176","0","184989","91","185256","0.01"
"2025-09-22T01:41:48.220Z","Included","claude-4-sonnet-thinking","Yes","344","0","184645","146","185135","0.01"
"2025-09-22T01:41:27.927Z","Included","claude-4-sonnet-thinking","Yes","2047","393","182598","170","185208","0.02"
"2025-09-22T01:41:22.288Z","Included","claude-4-sonnet-thinking","Yes","334","0","182264","130","182728","0.01"
"2025-09-22T01:41:18.093Z","Included","claude-4-sonnet-thinking","Yes","374","0","181890","145","182409","0.01"
"2025-09-22T01:41:12.778Z","Included","claude-4-sonnet-thinking","Yes","187","0","181703","148","182038","0.01"
"2025-09-22T01:41:09.279Z","Included","claude-4-sonnet-thinking","Yes","119","0","181584","88","181791","0.01"
"2025-09-22T01:41:05.142Z","Included","claude-4-sonnet-thinking","Yes","200","0","181384","89","181673","0.01"
"2025-09-22T01:40:42.628Z","Included","claude-4-sonnet-thinking","Yes","2048","394","179336","180","181958","0.02"
"2025-09-22T01:40:37.031Z","Included","claude-4-sonnet-thinking","Yes","596","0","178740","131","179467","0.01"
"2025-09-22T01:40:30.292Z","Included","claude-4-sonnet-thinking","Yes","424","0","178316","337","179077","0.01"
"2025-09-22T01:40:10.505Z","Included","claude-4-sonnet-thinking","Yes","2205","401","176111","184","178901","0.02"
"2025-09-22T01:40:04.991Z","Included","claude-4-sonnet-thinking","Yes","0","42","176111","246","176399","0.01"
"2025-09-22T01:39:36.445Z","Errored, Not Charged","claude-4-sonnet-thinking","No","0","396","0","10","406","0.000"
"2025-09-22T01:39:20.889Z","Included","claude-4-sonnet-thinking","Yes","236","394","175875","148","176653","0.01"
"2025-09-22T01:39:16.042Z","Included","claude-4-sonnet-thinking","Yes","548","0","175327","150","176025","0.01"
"2025-09-22T01:39:12.374Z","Included","claude-4-sonnet-thinking","Yes","542","0","174785","117","175444","0.01"
"2025-09-22T01:39:07.719Z","Included","claude-4-sonnet-thinking","Yes","323","0","174462","111","174896","0.01"
"2025-09-22T01:39:04.158Z","Included","claude-4-sonnet-thinking","Yes","137","0","174325","108","174570","0.01"
"2025-09-22T01:38:16.762Z","Included","claude-4-sonnet-thinking","Yes","589","394","173736","75","174794","0.01"
"2025-09-22T01:37:28.102Z","Included","claude-4-sonnet-thinking","Yes","645","399","173091","143","174278","0.01"
"2025-09-22T01:37:24.519Z","Included","claude-4-sonnet-thinking","Yes","187","49","172904","173","173313","0.01"
"2025-09-22T01:36:07.854Z","Included","claude-4-sonnet-thinking","Yes","162393","17","10511","167","173088","0.15"
"2025-09-22T01:33:59.043Z","Included","auto","No","9298","0","792765","2647","804710","0.23"
"2025-09-22T01:33:27.489Z","Errored, Not Charged","auto","No","23907","0","273723","870","298500","0.10"
"2025-09-22T01:30:16.754Z","Errored, Not Charged","auto","No","45028","100834","968363","7059","1121284","0.47"
"2025-09-22T00:38:56.309Z","Included","claude-4-sonnet-thinking","Yes","345","381","171666","900","173292","0.02"
"2025-09-22T00:38:40.550Z","Included","claude-4-sonnet-thinking","Yes","5318","392","166348","205","172263","0.02"
"2025-09-22T00:38:33.296Z","Included","claude-4-sonnet-thinking","Yes","707","0","165641","164","166512","0.01"
"2025-09-22T00:38:27.584Z","Included","claude-4-sonnet-thinking","Yes","439","0","165202","358","165999","0.01"
"2025-09-22T00:38:23.254Z","Included","claude-4-sonnet-thinking","Yes","324","0","164878","108","165310","0.01"
"2025-09-22T00:38:18.540Z","Included","claude-4-sonnet-thinking","Yes","480","0","164398","111","164989","0.01"
"2025-09-22T00:38:14.222Z","Included","claude-4-sonnet-thinking","Yes","201","0","164197","108","164506","0.01"
"2025-09-22T00:38:09.366Z","Included","claude-4-sonnet-thinking","Yes","349","0","163848","135","164332","0.01"
"2025-09-22T00:38:05.229Z","Included","claude-4-sonnet-thinking","Yes","159","0","163689","108","163956","0.01"
"2025-09-22T00:38:00.896Z","Included","claude-4-sonnet-thinking","Yes","139","0","163550","91","163780","0.01"
"2025-09-22T00:37:55.648Z","Included","claude-4-sonnet-thinking","Yes","433","0","163117","109","163659","0.01"
"2025-09-22T00:37:41.306Z","Included","claude-4-sonnet-thinking","Yes","9195","389","153922","193","163699","0.02"
"2025-09-22T00:37:34.028Z","Included","claude-4-sonnet-thinking","Yes","573","0","153349","133","154055","0.01"
"2025-09-22T00:37:29.204Z","Included","claude-4-sonnet-thinking","Yes","353","0","152996","302","153651","0.01"
"2025-09-22T00:37:14.846Z","Included","claude-4-sonnet-thinking","Yes","9581","387","143415","179","153562","0.02"
"2025-09-22T00:36:25.202Z","Included","claude-4-sonnet-thinking","Yes","362","396","143053","181","143992","0.01"
"2025-09-22T00:35:34.956Z","Included","claude-4-sonnet-thinking","Yes","250","391","142803","232","143676","0.01"
"2025-09-22T00:34:39.600Z","Included","claude-4-sonnet-thinking","Yes","310","393","142493","169","143365","0.01"
"2025-09-22T00:34:29.292Z","Included","claude-4-sonnet-thinking","Yes","1010","0","141483","172","142665","0.01"
"2025-09-22T00:33:27.210Z","Included","claude-4-sonnet-thinking","Yes","309","383","141174","536","142402","0.01"
"2025-09-22T00:33:18.866Z","Included","claude-4-sonnet-thinking","Yes","254","397","140920","169","141740","0.01"
"2025-09-22T00:33:05.959Z","Included","claude-4-sonnet-thinking","Yes","623","387","140297","178","141485","0.01"
"2025-09-22T00:33:00.478Z","Included","claude-4-sonnet-thinking","Yes","354","0","139943","131","140428","0.01"
"2025-09-22T00:32:48.767Z","Included","claude-4-sonnet-thinking","Yes","6397","382","133546","160","140485","0.02"
"2025-09-22T00:32:36.098Z","Included","claude-4-sonnet-thinking","Yes","885","379","132661","172","134097","0.01"
"2025-09-22T00:32:30.992Z","Included","claude-4-sonnet-thinking","Yes","396","0","132265","117","132778","0.01"
"2025-09-22T00:32:26.390Z","Included","claude-4-sonnet-thinking","Yes","353","0","131912","160","132425","0.01"
"2025-09-22T00:32:12.958Z","Included","claude-4-sonnet-thinking","Yes","5697","380","126215","150","132442","0.01"
"2025-09-22T00:32:04.978Z","Included","claude-4-sonnet-thinking","Yes","290","398","125925","131","126744","0.01"
"2025-09-22T00:31:55.411Z","Included","claude-4-sonnet-thinking","Yes","300","397","125625","197","126519","0.01"
"2025-09-22T00:30:58.962Z","Included","claude-4-sonnet-thinking","Yes","347","386","125278","219","126230","0.01"
"2025-09-22T00:30:46.773Z","Included","claude-4-sonnet-thinking","Yes","603","384","124675","207","125869","0.01"
"2025-09-22T00:30:40.836Z","Included","claude-4-sonnet-thinking","Yes","465","0","124210","122","124797","0.01"
"2025-09-22T00:30:28.745Z","Included","claude-4-sonnet-thinking","Yes","1032","384","123178","249","124843","0.01"
"2025-09-22T00:30:14.047Z","Included","claude-4-sonnet-thinking","Yes","609","388","122569","203","123769","0.01"
"2025-09-22T00:30:07.840Z","Included","claude-4-sonnet-thinking","Yes","638","0","121931","126","122695","0.01"
"2025-09-22T00:30:00.532Z","Included","claude-4-sonnet-thinking","Yes","442","0","121489","361","122292","0.01"
"2025-09-22T00:29:45.980Z","Included","claude-4-sonnet-thinking","Yes","4583","383","116906","235","122107","0.01"
"2025-09-22T00:29:31.686Z","Included","claude-4-sonnet-thinking","Yes","601","381","116305","196","117483","0.01"
"2025-09-22T00:29:25.721Z","Included","claude-4-sonnet-thinking","Yes","410","1","115895","119","116425","0.01"
"2025-09-22T00:29:20.782Z","Included","claude-4-sonnet-thinking","Yes","324","1","115571","179","116075","0.01"
"2025-09-22T00:29:07.776Z","Included","claude-4-sonnet-thinking","Yes","4978","383","110593","145","116099","0.01"
"2025-09-22T00:28:59.165Z","Included","claude-4-sonnet-thinking","Yes","303","398","110290","130","111121","0.01"
"2025-09-22T00:28:49.244Z","Included","claude-4-sonnet-thinking","Yes","256","405","110034","187","110882","0.01"
"2025-09-22T00:28:41.254Z","Included","claude-4-sonnet-thinking","Yes","681","4","109353","164","110202","0.01"
"2025-09-22T00:27:40.060Z","Included","claude-4-sonnet-thinking","Yes","303","391","109050","245","109989","0.01"
"2025-09-22T00:27:27.076Z","Included","claude-4-sonnet-thinking","Yes","602","393","108448","156","109599","0.01"
"2025-09-22T00:26:55.261Z","Included","claude-4-sonnet-thinking","Yes","97937","314029","10511","5437","427914","0.10"
"2025-09-22T00:26:37.312Z","Included","claude-4-sonnet-thinking","Yes","4487","384","558260","268","563399","0.05"
"2025-09-22T00:26:17.621Z","Included","claude-4-sonnet-thinking","Yes","594","380","557666","202","558842","0.04"
"2025-09-22T00:26:06.695Z","Included","claude-4-sonnet-thinking","Yes","460","0","557206","118","557784","0.04"
"2025-09-22T00:25:56.273Z","Included","claude-4-sonnet-thinking","Yes","353","0","556853","203","557409","0.04"
"2025-09-22T00:25:38.096Z","Included","claude-4-sonnet-thinking","Yes","1585","0","555268","128","556981","0.04"
"2025-09-22T00:25:26.149Z","Included","claude-4-sonnet-thinking","Yes","519","0","554749","850","556118","0.04"
"2025-09-22T00:25:06.758Z","Included","claude-4-sonnet-thinking","Yes","4370","382","550379","256","555387","0.04"
"2025-09-22T00:24:53.484Z","Included","claude-4-sonnet-thinking","Yes","285","401","550094","130","550910","0.04"
"2025-09-22T00:09:35.226Z","Errored, Not Charged","claude-4-sonnet-thinking","No","0","698","0","10","708","0.000"
"2025-09-22T00:08:32.222Z","Included","claude-4-sonnet-thinking","Yes","303","380","549231","538","550452","0.04"
"2025-09-22T00:08:13.288Z","Included","claude-4-sonnet-thinking","Yes","637","395","548594","157","549783","0.04"
"2025-09-22T00:07:59.162Z","Included","claude-4-sonnet-thinking","Yes","716","0","547878","135","548729","0.04"
"2025-09-22T00:07:39.707Z","Included","claude-4-sonnet-thinking","Yes","4801","393","543077","466","548737","0.05"
"2025-09-22T00:07:24.578Z","Included","claude-4-sonnet-thinking","Yes","1167","0","541910","132","543209","0.04"
"2025-09-22T00:07:06.805Z","Included","claude-4-sonnet-thinking","Yes","4566","387","537344","641","542938","0.05"
"2025-09-22T00:06:47.981Z","Included","claude-4-sonnet-thinking","Yes","610","387","536734","183","537914","0.04"
"2025-09-22T00:06:36.093Z","Included","claude-4-sonnet-thinking","Yes","436","0","536298","126","536860","0.04"
"2025-09-22T00:06:24.648Z","Included","claude-4-sonnet-thinking","Yes","371","0","535927","199","536497","0.04"
"2025-09-22T00:06:06.677Z","Included","claude-4-sonnet-thinking","Yes","4505","385","531422","156","536468","0.04"
"2025-09-22T00:05:53.067Z","Included","claude-4-sonnet-thinking","Yes","323","397","531099","133","531952","0.04"
"2025-09-22T00:04:50.870Z","Included","claude-4-sonnet-thinking","Yes","231","385","530868","210","531694","0.04"
"2025-09-22T00:03:49.782Z","Included","claude-4-sonnet-thinking","Yes","355","390","530513","150","531408","0.04"
"2025-09-22T00:03:30.790Z","Included","claude-4-sonnet-thinking","Yes","615","388","529898","209","531110","0.04"
"2025-09-22T00:03:19.124Z","Included","claude-4-sonnet-thinking","Yes","358","0","529540","128","530026","0.04"
"2025-09-22T00:03:09.313Z","Included","claude-4-sonnet-thinking","Yes","164","0","529376","160","529700","0.04"
"2025-09-22T00:02:59.049Z","Included","claude-4-sonnet-thinking","Yes","326","0","529050","90","529466","0.04"
"2025-09-22T00:02:41.204Z","Included","claude-4-sonnet-thinking","Yes","1046","384","528004","147","529581","0.04"
"2025-09-22T00:02:21.615Z","Included","claude-4-sonnet-thinking","Yes","599","382","527405","199","528585","0.04"
"2025-09-22T00:02:06.977Z","Included","claude-4-sonnet-thinking","Yes","1017","0","526388","122","527527","0.04"
"2025-09-22T00:01:55.321Z","Included","claude-4-sonnet-thinking","Yes","383","0","526005","562","526950","0.04"
"2025-09-22T00:01:36.923Z","Included","claude-4-sonnet-thinking","Yes","4517","384","521488","171","526560","0.04"
"2025-09-22T00:01:23.314Z","Included","claude-4-sonnet-thinking","Yes","329","397","521159","134","522019","0.04"
"2025-09-22T00:00:21.445Z","Included","claude-4-sonnet-thinking","Yes","355","384","520804","215","521758","0.04"
"2025-09-22T00:00:01.686Z","Included","claude-4-sonnet-thinking","Yes","597","382","520207","209","521395","0.04"
"2025-09-21T23:59:50.657Z","Included","claude-4-sonnet-thinking","Yes","415","0","519792","120","520327","0.04"
"2025-09-21T23:59:41.396Z","Included","auto","No","7043","0","1989619","3808","2000470","0.53"
"2025-09-21T23:59:40.798Z","Included","claude-4-sonnet-thinking","Yes","297","0","519495","170","519962","0.04"
"2025-09-21T23:59:22.973Z","Included","claude-4-sonnet-thinking","Yes","5171","386","514324","148","520029","0.04"
"2025-09-21T23:59:09.883Z","Errored, Not Charged","auto","No","2323","0","209835","257","212415","0.06"
"2025-09-21T23:59:09.209Z","Included","claude-4-sonnet-thinking","Yes","331","398","513993","134","514856","0.04"
"2025-09-21T23:58:05.881Z","Included","claude-4-sonnet-thinking","Yes","309","382","513684","216","514591","0.04"
"2025-09-21T23:57:48.041Z","Included","claude-4-sonnet-thinking","Yes","887","381","512797","169","514234","0.04"
"2025-09-21T23:57:37.037Z","Included","auto","No","8212","0","1005302","1344","1014858","0.27"
"2025-09-21T23:57:37.028Z","Included","claude-4-sonnet-thinking","Yes","491","0","512306","119","512916","0.04"
"2025-09-21T23:57:18.748Z","Included","claude-4-sonnet-thinking","Yes","4998","380","507308","232","512918","0.04"
"2025-09-21T23:57:09.385Z","Errored, Not Charged","auto","No","0","0","0","0","0","0.00"
"2025-09-21T23:57:07.657Z","Included","claude-4-sonnet-thinking","Yes","522","0","506786","118","507426","0.04"
"2025-09-21T23:56:58.372Z","Included","claude-4-sonnet-thinking","Yes","295","0","506491","236","507022","0.04"
"2025-09-21T23:56:42.607Z","Included","claude-4-sonnet-thinking","Yes","4749","384","501742","122","506997","0.04"
"2025-09-21T23:56:25.824Z","Included","claude-4-sonnet-thinking","Yes","600","381","501142","157","502280","0.04"
"2025-09-21T23:56:15.097Z","Included","claude-4-sonnet-thinking","Yes","535","0","500607","121","501263","0.04"
"2025-09-21T23:55:59.141Z","Included","claude-4-sonnet-thinking","Yes","1529","0","499078","271","500878","0.04"
"2025-09-21T23:55:55.386Z","Included","auto","No","17986","0","743161","981","762128","0.21"
"2025-09-21T23:55:42.975Z","Errored, Not Charged","claude-4-sonnet-thinking","Yes","1159","0","497919","786","499864","0.04"
"2025-09-21T23:55:32.510Z","Included","claude-4-sonnet-thinking","Yes","536","0","497383","787","498706","0.04"
"2025-09-21T23:55:22.778Z","Included","claude-4-sonnet-thinking","Yes","327","0","497056","260","497643","0.04"
"2025-09-21T23:55:13.129Z","Included","claude-4-sonnet-thinking","Yes","417","0","496639","139","497195","0.04"
"2025-09-21T23:54:55.248Z","Included","claude-4-sonnet-thinking","Yes","4421","385","492218","184","497208","0.04"
"2025-09-21T23:54:42.316Z","Included","claude-4-sonnet-thinking","Yes","339","398","491879","156","492772","0.04"
"2025-09-21T23:53:38.991Z","Included","claude-4-sonnet-thinking","Yes","303","381","491576","227","492487","0.04"
"2025-09-21T23:53:23.112Z","Included","claude-4-sonnet-thinking","Yes","887","380","490689","163","492119","0.04"
"2025-09-21T23:53:12.953Z","Included","claude-4-sonnet-thinking","Yes","471","0","490218","118","490807","0.04"
"2025-09-21T23:53:03.872Z","Included","claude-4-sonnet-thinking","Yes","371","0","489847","208","490426","0.04"
"2025-09-21T23:52:58.703Z","Included","auto","No","15795","0","1637149","3082","1656026","0.45"
"2025-09-21T23:52:50.783Z","Included","claude-4-sonnet-thinking","Yes","311","399","489536","153","490399","0.04"
"2025-09-21T23:52:37.908Z","Included","claude-4-sonnet-thinking","Yes","515","396","489021","200","490132","0.04"
"2025-09-21T23:51:32.908Z","Included","claude-4-sonnet-thinking","Yes","330","382","488691","434","489837","0.04"
"2025-09-21T23:51:19.086Z","Included","claude-4-sonnet-thinking","Yes","893","384","487798","190","489265","0.04"
"2025-09-21T23:51:01.755Z","Included","claude-4-sonnet-thinking","Yes","676","385","487122","207","488390","0.04"
"2025-09-21T23:50:52.266Z","Included","claude-4-sonnet-thinking","Yes","444","0","486678","123","487245","0.04"
"2025-09-21T23:50:42.368Z","Included","claude-4-sonnet-thinking","Yes","296","0","486382","251","486929","0.04"
"2025-09-21T23:50:24.171Z","Included","claude-4-sonnet-thinking","Yes","4089","384","482293","162","486928","0.04"
"2025-09-21T23:50:13.486Z","Included","claude-4-sonnet-thinking","Yes","587","0","481706","122","482415","0.04"
"2025-09-21T23:50:01.088Z","Included","claude-4-sonnet-thinking","Yes","844","0","480862","289","481995","0.04"
"2025-09-21T23:49:53.372Z","Included","claude-4-sonnet-thinking","Yes","10","44","480852","437","481343","0.04"
"2025-09-21T23:49:22.551Z","Errored, Not Charged","claude-4-sonnet-thinking","Yes","0","0","0","0","0","0.00"
"2025-09-21T23:49:09.477Z","Included","claude-4-sonnet-thinking","Yes","353","0","480499","138","480990","0.04"
"2025-09-21T23:48:51.528Z","Included","claude-4-sonnet-thinking","Yes","2022","386","478477","186","481071","0.04"
"2025-09-21T23:47:59.156Z","Included","claude-4-sonnet-thinking","Yes","336","399","478141","136","479012","0.04"
"2025-09-21T23:47:40.934Z","Included","claude-4-sonnet-thinking","Yes","4087","382","474054","205","478728","0.04"
"2025-09-21T23:47:30.457Z","Included","claude-4-sonnet-thinking","Yes","566","0","473488","120","474174","0.04"
"2025-09-21T23:47:21.086Z","Included","claude-4-sonnet-thinking","Yes","311","0","473177","306","473794","0.04"
"2025-09-21T23:47:09.251Z","Included","claude-4-sonnet-thinking","Yes","276","395","472901","177","473749","0.03"
"2025-09-21T23:46:07.344Z","Included","claude-4-sonnet-thinking","Yes","351","389","472550","152","473442","0.03"
"2025-09-21T23:45:14.334Z","Errored, Not Charged","auto","No","70000","0","1830286","10219","1910505","0.61"
"2025-09-21T23:45:06.201Z","Included","claude-4-sonnet-thinking","Yes","295","385","472255","179","473114","0.03"
"2025-09-21T23:43:48.727Z","Included","claude-4-sonnet-thinking","Yes","353","387","471902","135","472777","0.03"
"2025-09-21T23:43:32.529Z","Included","claude-4-sonnet-thinking","Yes","461391","20","10511","158","472080","0.42"
"2025-09-21T22:19:34.468Z","Included","claude-4-sonnet-thinking","Yes","278","396","471033","598","472305","0.04"
"2025-09-21T22:19:22.453Z","Included","claude-4-sonnet-thinking","Yes","494","408","470539","197","471638","0.04"
"2025-09-21T22:19:12.466Z","Included","claude-4-sonnet-thinking","Yes","350","364","470189","158","471061","0.03"
"2025-09-21T22:03:55.969Z","Errored, Not Charged","claude-4-sonnet-thinking","No","0","710","0","60","770","0.000"
"2025-09-21T22:03:33.445Z","Included","claude-4-sonnet-thinking","Yes","2087","389","467555","525","470556","0.04"
"2025-09-21T22:02:40.814Z","Included","claude-4-sonnet-thinking","Yes","271","400","467284","139","468094","0.03"
"2025-09-21T22:02:27.271Z","Included","claude-4-sonnet-thinking","Yes","353","399","466931","184","467867","0.03"
"2025-09-21T22:01:25.288Z","Included","claude-4-sonnet-thinking","Yes","327","384","466604","242","467557","0.03"
"2025-09-21T22:01:15.233Z","Errored, Not Charged","claude-4-sonnet-thinking","Yes","232","0","466372","177","466781","0.03"
"2025-09-21T22:01:06.625Z","Included","claude-4-sonnet-thinking","Yes","151","0","466221","174","466546","0.03"
"2025-09-21T22:00:58.810Z","Included","claude-4-sonnet-thinking","Yes","119","0","466102","89","466310","0.03"
"2025-09-21T22:00:50.488Z","Included","claude-4-sonnet-thinking","Yes","192","0","465910","89","466191","0.03"
"2025-09-21T22:00:31.927Z","Included","claude-4-sonnet-thinking","Yes","9541","388","456369","172","466470","0.04"
"2025-09-21T22:00:23.490Z","Included","claude-4-sonnet-thinking","Yes","330","0","456039","131","456500","0.03"
"2025-09-21T22:00:14.705Z","Included","claude-4-sonnet-thinking","Yes","329","0","455710","126","456165","0.03"
"2025-09-21T22:00:06.764Z","Included","claude-4-sonnet-thinking","Yes","405","0","455305","136","455846","0.03"
"2025-09-21T21:59:55.431Z","Errored, Not Charged","claude-4-sonnet-thinking","Yes","421","0","454884","108","455413","0.03"
"2025-09-21T21:59:47.589Z","Included","claude-4-sonnet-thinking","Yes","363","0","454521","326","455210","0.03"
"2025-09-21T21:59:39.238Z","Included","claude-4-sonnet-thinking","Yes","184","0","454337","108","454629","0.03"
"2025-09-21T21:59:30.412Z","Included","claude-4-sonnet-thinking","Yes","404","0","453933","90","454427","0.03"
"2025-09-21T21:59:11.710Z","Included","claude-4-sonnet-thinking","Yes","8956","389","444977","179","454501","0.04"
"2025-09-21T21:58:19.323Z","Included","claude-4-sonnet-thinking","Yes","296","397","444681","140","445514","0.03"
"2025-09-21T21:57:26.372Z","Included","claude-4-sonnet-thinking","Yes","224","393","444457","166","445240","0.03"
"2025-09-21T21:57:14.862Z","Included","claude-4-sonnet-thinking","Yes","289","397","444168","143","444997","0.03"
"2025-09-21T21:56:12.527Z","Included","claude-4-sonnet-thinking","Yes","348","380","443820","208","444756","0.03"
"2025-09-21T21:55:54.812Z","Included","claude-4-sonnet-thinking","Yes","4122","393","439698","208","444421","0.04"
"2025-09-21T21:55:43.046Z","Included","claude-4-sonnet-thinking","Yes","867","0","438831","133","439831","0.03"
"2025-09-21T21:55:24.810Z","Included","claude-4-sonnet-thinking","Yes","7555","389","431276","496","439716","0.04"
"2025-09-21T21:55:11.604Z","Included","claude-4-sonnet-thinking","Yes","291","398","430985","171","431845","0.03"
"2025-09-21T21:54:58.513Z","Included","claude-4-sonnet-thinking","Yes","264","395","430721","196","431576","0.03"
"2025-09-21T21:53:57.372Z","Included","claude-4-sonnet-thinking","Yes","572","396","430149","183","431300","0.03"
"2025-09-21T21:53:43.873Z","Included","claude-4-sonnet-thinking","Yes","639","0","429510","390","430539","0.03"
"2025-09-21T21:52:42.873Z","Included","claude-4-sonnet-thinking","Yes","318","386","429192","257","430153","0.03"
"2025-09-21T21:52:31.295Z","Included","claude-4-sonnet-thinking","Yes","826","386","428366","178","429756","0.03"
"2025-09-21T21:52:13.831Z","Included","claude-4-sonnet-thinking","Yes","714","388","427652","172","428926","0.03"
"2025-09-21T21:52:05.465Z","Included","claude-4-sonnet-thinking","Yes","358","0","427294","134","427786","0.03"
"2025-09-21T21:51:58.313Z","Included","claude-4-sonnet-thinking","Yes","305","0","426989","215","427509","0.03"
"2025-09-21T21:51:49.567Z","Included","claude-4-sonnet-thinking","Yes","393","0","426596","109","427098","0.03"
"2025-09-21T21:51:41.601Z","Included","claude-4-sonnet-thinking","Yes","372","0","426224","227","426823","0.03"
"2025-09-21T21:51:34.227Z","Included","claude-4-sonnet-thinking","Yes","177","0","426047","109","426333","0.03"
"2025-09-21T21:51:26.869Z","Included","claude-4-sonnet-thinking","Yes","240","0","425807","89","426136","0.03"
"2025-09-21T21:51:08.853Z","Included","claude-4-sonnet-thinking","Yes","9094","396","416713","153","426356","0.04"
"2025-09-21T21:50:55.925Z","Included","claude-4-sonnet-thinking","Yes","1041","0","415672","141","416854","0.03"
"2025-09-21T21:50:38.292Z","Included","claude-4-sonnet-thinking","Yes","10749","399","404923","614","416685","0.04"
"2025-09-21T21:50:26.585Z","Included","claude-4-sonnet-thinking","Yes","311","405","404612","179","405507","0.03"
"2025-09-21T21:50:14.900Z","Included","claude-4-sonnet-thinking","Yes","300","399","404312","198","405209","0.03"
"2025-09-21T21:49:13.863Z","Included","claude-4-sonnet-thinking","Yes","305","383","404007","218","404913","0.03"
"2025-09-21T21:48:56.790Z","Included","claude-4-sonnet-thinking","Yes","680","384","403327","158","404549","0.03"
"2025-09-21T21:48:46.109Z","Included","claude-4-sonnet-thinking","Yes","1937","377","401390","128","403832","0.03"
"2025-09-21T21:48:34.996Z","Included","claude-4-sonnet-thinking","Yes","390879","52","10511","148","401590","0.35"
"2025-09-21T21:41:16.604Z","Included","claude-4-sonnet-thinking","Yes","403","391","411282","426","412502","0.03"
"2025-09-21T21:40:57.982Z","Included","claude-4-sonnet-thinking","Yes","703","380","410579","251","411913","0.03"
"2025-09-21T21:40:48.608Z","Included","claude-4-sonnet-thinking","Yes","415","0","410164","136","410715","0.03"
"2025-09-21T21:40:40.945Z","Included","claude-4-sonnet-thinking","Yes","372","0","409792","253","410417","0.03"
"2025-09-21T21:40:31.341Z","Errored, Not Charged","claude-4-sonnet-thinking","Yes","351","0","409441","131","409923","0.03"
"2025-09-21T21:40:23.415Z","Included","claude-4-sonnet-thinking","Yes","286","0","409155","280","409721","0.03"
"2025-09-21T21:40:15.000Z","Included","claude-4-sonnet-thinking","Yes","313","0","408842","139","409294","0.03"
"2025-09-21T21:39:57.038Z","Included","claude-4-sonnet-thinking","Yes","4913","391","403929","229","409462","0.03"
"2025-09-21T21:39:45.042Z","Included","claude-4-sonnet-thinking","Yes","841","0","403088","153","404082","0.03"
"2025-09-21T21:39:26.933Z","Included","claude-4-sonnet-thinking","Yes","8813","389","394275","520","403997","0.04"
"2025-09-21T21:38:20.700Z","Included","claude-4-sonnet-thinking","Yes","377","384","393898","482","395141","0.03"
"2025-09-21T21:38:02.358Z","Included","claude-4-sonnet-thinking","Yes","713","383","393185","231","394512","0.03"
"2025-09-21T21:37:52.092Z","Included","claude-4-sonnet-thinking","Yes","603","0","392582","140","393325","0.03"
"2025-09-21T21:37:35.644Z","Included","claude-4-sonnet-thinking","Yes","4651","386","387931","353","393321","0.03"
"2025-09-21T21:37:24.128Z","Included","claude-4-sonnet-thinking","Yes","415","399","387516","196","388526","0.03"
"2025-09-21T21:36:29.776Z","Included","claude-4-sonnet-thinking","Yes","284","404","387232","294","388214","0.03"
"2025-09-21T21:35:29.685Z","Included","claude-4-sonnet-thinking","Yes","511","395","386721","197","387824","0.03"
"2025-09-21T21:35:16.093Z","Included","claude-4-sonnet-thinking","Yes","722","395","385999","309","387425","0.03"
"2025-09-21T21:34:07.022Z","Included","claude-4-sonnet-thinking","Yes","378","385","385621","635","387019","0.03"
"2025-09-21T21:33:51.490Z","Included","claude-4-sonnet-thinking","Yes","289","5","26277","443","27014","0.004"
"2025-09-21T21:33:48.968Z","Included","claude-4-sonnet-thinking","Yes","705","380","384916","226","386227","0.03"
"2025-09-21T21:33:46.214Z","Included","claude-4-sonnet-thinking","Yes","250","373","26027","159","26809","0.003"
"2025-09-21T21:33:42.276Z","Included","claude-4-sonnet-thinking","Yes","301","6","25726","137","26170","0.003"
"2025-09-21T21:33:40.034Z","Included","claude-4-sonnet-thinking","Yes","438","0","384478","137","385053","0.03"
"2025-09-21T21:33:36.683Z","Included","claude-4-sonnet-thinking","Yes","411","372","25315","169","26267","0.003"
"2025-09-21T21:33:31.697Z","Included","claude-4-sonnet-thinking","Yes","333","0","384145","270","384748","0.03"
"2025-09-21T21:33:30.577Z","Included","claude-4-sonnet-thinking","Yes","648","381","24667","161","25857","0.003"
"2025-09-21T21:33:24.226Z","Included","claude-4-sonnet-thinking","Yes","630","379","24037","190","25236","0.003"
"2025-09-21T21:33:24.146Z","Included","claude-4-sonnet-thinking","Yes","258","0","383887","140","384285","0.03"
"2025-09-21T21:33:17.303Z","Included","claude-4-sonnet-thinking","Yes","395","382","23642","208","24627","0.003"
"2025-09-21T21:33:13.063Z","Included","claude-4-sonnet-thinking","Yes","349","10","23293","167","23819","0.003"
"2025-09-21T21:33:06.967Z","Included","claude-4-sonnet-thinking","Yes","4850","381","379037","171","384439","0.03"
"2025-09-21T21:33:06.654Z","Included","claude-4-sonnet-thinking","Yes","508","383","22785","217","23893","0.003"
"2025-09-21T21:33:01.727Z","Included","claude-4-sonnet-thinking","Yes","326","11","22459","177","22973","0.003"
"2025-09-21T21:32:57.171Z","Included","claude-4-sonnet-thinking","Yes","577","0","378460","144","379181","0.03"
"2025-09-21T21:32:40.093Z","Included","claude-4-sonnet-thinking","Yes","4650","387","373810","347","379194","0.03"
"2025-09-21T21:32:30.162Z","Included","claude-4-sonnet-thinking","Yes","470","0","373340","160","373970","0.03"
"2025-09-21T21:32:14.438Z","Included","claude-4-sonnet-thinking","Yes","4617","384","368723","270","373994","0.03"
"2025-09-21T21:32:02.201Z","Included","claude-4-sonnet-thinking","Yes","578","402","368145","202","369327","0.03"
"2025-09-21T21:31:46.477Z","Included","claude-4-sonnet-thinking","Yes","2400","379","20059","278","23116","0.005"
"2025-09-21T21:31:46.445Z","Included","claude-4-sonnet-thinking","Yes","507","405","367638","478","369028","0.03"
"2025-09-21T21:31:38.807Z","Included","claude-4-sonnet-thinking","Yes","9548","1989","10511","285","22333","0.01"
"2025-09-21T21:16:32.124Z","Errored, Not Charged","claude-4-sonnet-thinking","No","0","634","0","10","644","0.000"
"2025-09-21T21:15:28.162Z","Included","claude-4-sonnet-thinking","Yes","370","381","366693","547","367991","0.03"
"2025-09-21T21:15:10.586Z","Included","claude-4-sonnet-thinking","Yes","700","380","365993","224","367297","0.03"
"2025-09-21T21:15:02.111Z","Included","claude-4-sonnet-thinking","Yes","506","0","365487","133","366126","0.03"
"2025-09-21T21:14:46.322Z","Included","claude-4-sonnet-thinking","Yes","4553","382","360934","262","366131","0.03"
"2025-09-21T21:14:35.444Z","Included","claude-4-sonnet-thinking","Yes","365","397","360569","158","361489","0.03"
"2025-09-21T21:14:22.596Z","Included","claude-4-sonnet-thinking","Yes","395","394","360174","251","361214","0.03"
"2025-09-21T21:13:19.944Z","Included","claude-4-sonnet-thinking","Yes","403","384","359771","308","360866","0.03"
"2025-09-21T21:13:02.358Z","Included","claude-4-sonnet-thinking","Yes","396","396","359375","257","360424","0.03"
"2025-09-21T21:12:54.074Z","Included","claude-4-sonnet-thinking","Yes","452","0","358923","158","359533","0.03"
"2025-09-21T21:12:44.226Z","Included","claude-4-sonnet-thinking","Yes","638","0","358285","257","359180","0.03"
"2025-09-21T21:12:34.280Z","Included","claude-4-sonnet-thinking","Yes","331","0","357954","355","358640","0.03"
"2025-09-21T21:12:18.052Z","Included","claude-4-sonnet-thinking","Yes","413","394","357541","160","358508","0.03"
"2025-09-21T21:12:08.789Z","Included","claude-4-sonnet-thinking","Yes","646","0","356895","157","357698","0.03"
"2025-09-21T21:12:00.619Z","Included","claude-4-sonnet-thinking","Yes","496","0","356399","299","357194","0.03"
"2025-09-21T21:11:44.619Z","Included","claude-4-sonnet-thinking","Yes","6440","380","349959","279","357058","0.03"
"2025-09-21T21:10:44.057Z","Included","claude-4-sonnet-thinking","Yes","379","384","349580","262","350605","0.03"
"2025-09-21T21:10:26.452Z","Included","claude-4-sonnet-thinking","Yes","700","380","348880","227","350187","0.03"
"2025-09-21T21:10:17.274Z","Included","claude-4-sonnet-thinking","Yes","501","0","348379","134","349014","0.03"
"2025-09-21T21:10:01.792Z","Included","claude-4-sonnet-thinking","Yes","4570","382","343809","268","349029","0.03"
"2025-09-21T21:09:50.929Z","Included","claude-4-sonnet-thinking","Yes","373","397","343436","160","344366","0.03"
"2025-09-21T21:09:41.153Z","Included","claude-4-sonnet-thinking","Yes","678","0","342758","251","343687","0.03"
"2025-09-21T21:08:38.044Z","Included","claude-4-sonnet-thinking","Yes","408","382","342350","316","343456","0.03"
"2025-09-21T21:08:17.646Z","Included","claude-4-sonnet-thinking","Yes","2524","636","339826","262","343248","0.03"
"2025-09-21T21:07:09.139Z","Included","claude-4-sonnet-thinking","Yes","379","382","339447","517","340725","0.03"
"2025-09-21T21:06:51.461Z","Included","claude-4-sonnet-thinking","Yes","1045","387","338402","233","340067","0.03"
"2025-09-21T21:06:39.335Z","Included","claude-4-sonnet-thinking","Yes","1132","0","337270","151","338553","0.03"
"2025-09-21T21:06:22.324Z","Included","claude-4-sonnet-thinking","Yes","9069","386","328201","613","338269","0.03"
"2025-09-21T21:06:11.612Z","Included","claude-4-sonnet-thinking","Yes","985","0","327216","160","328361","0.03"
"2025-09-21T21:05:55.074Z","Included","claude-4-sonnet-thinking","Yes","9090","389","318126","526","328131","0.03"
"2025-09-21T21:05:05.081Z","Included","claude-4-sonnet-thinking","Yes","349","399","317777","167","318692","0.02"
"2025-09-21T21:04:12.036Z","Included","claude-4-sonnet-thinking","Yes","418","394","317359","214","318385","0.02"
"2025-09-21T21:03:52.576Z","Included","claude-4-sonnet-thinking","Yes","4110","383","313249","331","318073","0.03"
"2025-09-21T21:03:44.391Z","Included","claude-4-sonnet-thinking","Yes","618","0","312631","137","313386","0.02"
"2025-09-21T21:03:28.721Z","Included","claude-4-sonnet-thinking","Yes","4109","382","308522","345","313358","0.03"
"2025-09-21T21:03:20.716Z","Included","claude-4-sonnet-thinking","Yes","497","0","308025","136","308658","0.02"
"2025-09-21T21:03:12.472Z","Errored, Not Charged","claude-4-sonnet-thinking","Yes","581","0","307444","296","308321","0.02"
"2025-09-21T21:03:06.427Z","Included","claude-4-sonnet-thinking","Yes","327","0","307117","291","307735","0.02"
"2025-09-21T21:02:59.921Z","Included","claude-4-sonnet-thinking","Yes","240","0","306877","140","307257","0.02"
"2025-09-21T21:02:44.864Z","Included","claude-4-sonnet-thinking","Yes","4450","382","302427","126","307385","0.03"
"2025-09-21T21:02:32.948Z","Included","claude-4-sonnet-thinking","Yes","1051","0","301376","143","302570","0.02"
"2025-09-21T21:02:17.298Z","Included","claude-4-sonnet-thinking","Yes","4137","393","297239","556","302325","0.03"
"2025-09-21T21:02:06.165Z","Included","claude-4-sonnet-thinking","Yes","330","394","296909","174","297807","0.02"
"2025-09-21T21:01:54.722Z","Included","claude-4-sonnet-thinking","Yes","292","390","296617","244","297543","0.02"
"2025-09-21T21:01:44.493Z","Included","claude-4-sonnet-thinking","Yes","266","392","296351","205","297214","0.02"
"2025-09-21T21:01:34.659Z","Included","claude-4-sonnet-thinking","Yes","416","387","295935","179","296917","0.02"
"2025-09-21T21:00:32.777Z","Included","claude-4-sonnet-thinking","Yes","559","390","295376","308","296633","0.02"
"2025-09-21T21:00:12.317Z","Included","claude-4-sonnet-thinking","Yes","703","381","294673","413","296170","0.02"
"2025-09-21T21:00:03.145Z","Included","claude-4-sonnet-thinking","Yes","672","0","294001","134","294807","0.02"
"2025-09-21T20:59:48.260Z","Included","claude-4-sonnet-thinking","Yes","4617","384","289384","312","294697","0.03"
"2025-09-21T20:59:35.307Z","Included","claude-4-sonnet-thinking","Yes","310","409","289074","216","290009","0.02"
"2025-09-21T20:58:36.702Z","Included","claude-4-sonnet-thinking","Yes","431","389","288643","223","289686","0.02"
"2025-09-21T20:57:36.590Z","Included","claude-4-sonnet-thinking","Yes","313","383","288330","293","289319","0.02"
"2025-09-21T20:57:21.764Z","Included","claude-4-sonnet-thinking","Yes","704","379","287626","167","288876","0.02"
"2025-09-21T20:57:11.707Z","Included","claude-4-sonnet-thinking","Yes","776","0","286850","135","287761","0.02"
"2025-09-21T20:56:57.067Z","Included","claude-4-sonnet-thinking","Yes","4574","382","282276","419","287651","0.03"
"2025-09-21T20:56:46.975Z","Included","claude-4-sonnet-thinking","Yes","314","397","281962","157","282830","0.02"
"2025-09-21T20:56:32.324Z","Included","claude-4-sonnet-thinking","Yes","781","586","281181","252","282800","0.02"
"2025-09-21T20:55:34.029Z","Included","claude-4-sonnet-thinking","Yes","334","382","280847","439","282002","0.02"
"2025-09-21T20:55:18.171Z","Included","claude-4-sonnet-thinking","Yes","711","386","280136","182","281415","0.02"
"2025-09-21T20:55:10.106Z","Included","claude-4-sonnet-thinking","Yes","482","0","279654","139","280275","0.02"
"2025-09-21T20:54:55.516Z","Included","claude-4-sonnet-thinking","Yes","4582","385","275072","259","280298","0.02"
"2025-09-21T20:54:45.528Z","Included","claude-4-sonnet-thinking","Yes","332","397","274740","150","275619","0.02"
"2025-09-21T20:54:36.976Z","Included","claude-4-sonnet-thinking","Yes","565","0","274175","205","274945","0.02"
"2025-09-21T20:53:37.855Z","Included","claude-4-sonnet-thinking","Yes","323","378","273852","259","274812","0.02"
"2025-09-21T20:53:21.754Z","Included","claude-4-sonnet-thinking","Yes","717","385","273135","171","274408","0.02"
"2025-09-21T20:53:13.333Z","Included","claude-4-sonnet-thinking","Yes","800","0","272335","142","273277","0.02"
"2025-09-21T20:53:03.596Z","Included","claude-4-sonnet-thinking","Yes","901","0","271434","381","272716","0.02"
"2025-09-21T20:52:46.637Z","Errored, Not Charged","claude-4-sonnet-thinking","Yes","1833","0","269601","450","271884","0.02"
"2025-09-21T20:52:32.505Z","Included","claude-4-sonnet-thinking","Yes","4595","386","265006","1224","271211","0.03"
"2025-09-21T20:52:17.667Z","Included","claude-4-sonnet-thinking","Yes","704","381","264302","166","265553","0.02"
"2025-09-21T20:52:10.467Z","Included","claude-4-sonnet-thinking","Yes","413","0","263889","135","264437","0.02"
"2025-09-21T20:52:03.984Z","Included","claude-4-sonnet-thinking","Yes","334","0","263555","265","264154","0.02"
"2025-09-21T20:51:58.097Z","Included","claude-4-sonnet-thinking","Yes","238","0","263317","142","263697","0.02"
"2025-09-21T20:51:43.507Z","Included","claude-4-sonnet-thinking","Yes","4875","381","258442","138","263836","0.02"
"2025-09-21T20:51:35.758Z","Included","claude-4-sonnet-thinking","Yes","656","0","257786","134","258576","0.02"
"2025-09-21T20:51:21.275Z","Included","claude-4-sonnet-thinking","Yes","4626","383","253160","320","258489","0.02"
"2025-09-21T20:51:20.588Z","Included","claude-4-sonnet-thinking","Yes","719","24","174452","377","175572","0.01"
"2025-09-21T20:51:11.545Z","Included","claude-4-sonnet-thinking","Yes","344","397","252816","163","253720","0.02"
"2025-09-21T20:50:31.670Z","Included","claude-4-sonnet-thinking","Yes","713","40","173739","1060","175552","0.02"
"2025-09-21T20:50:10.194Z","Included","claude-4-sonnet-thinking","Yes","338","380","252478","227","253423","0.02"
"2025-09-21T20:49:52.957Z","Included","claude-4-sonnet-thinking","Yes","2362","586","250116","192","253256","0.02"
"2025-09-21T20:49:38.513Z","Included","claude-4-sonnet-thinking","Yes","715","386","249401","364","250866","0.02"
"2025-09-21T20:49:27.799Z","Included","claude-4-sonnet-thinking","Yes","1078","0","248323","139","249540","0.02"
"2025-09-21T20:49:14.254Z","Included","claude-4-sonnet-thinking","Yes","4555","390","243768","566","249279","0.02"
"2025-09-21T20:49:04.296Z","Included","claude-4-sonnet-thinking","Yes","349","387","243419","193","244348","0.02"
"2025-09-21T20:48:49.542Z","Included","claude-4-sonnet-thinking","Yes","708","381","242711","209","244009","0.02"
"2025-09-21T20:48:42.128Z","Included","claude-4-sonnet-thinking","Yes","434","0","242277","141","242852","0.02"
"2025-09-21T20:48:34.572Z","Included","claude-4-sonnet-thinking","Yes","325","0","241952","262","242539","0.02"
"2025-09-21T20:48:28.598Z","Included","claude-4-sonnet-thinking","Yes","227","0","241725","135","242087","0.02"
"2025-09-21T20:48:13.037Z","Included","claude-4-sonnet-thinking","Yes","4956","383","236769","156","242264","0.02"
"2025-09-21T20:48:01.023Z","Included","claude-4-sonnet-thinking","Yes","1379","0","235390","143","236912","0.02"
"2025-09-21T20:47:52.283Z","Included","claude-4-sonnet-thinking","Yes","667","0","234723","769","236159","0.02"
"2025-09-21T20:47:43.820Z","Included","claude-4-sonnet-thinking","Yes","512","0","234211","312","235035","0.02"
"2025-09-21T20:47:37.174Z","Included","claude-4-sonnet-thinking","Yes","269","0","233942","267","234478","0.02"
"2025-09-21T20:47:31.478Z","Included","claude-4-sonnet-thinking","Yes","491","0","233451","116","234058","0.02"
"2025-09-21T20:47:21.725Z","Included","claude-4-sonnet-thinking","Yes","430","0","233021","229","233680","0.02"
"2025-09-21T20:47:06.881Z","Included","claude-4-sonnet-thinking","Yes","1167","384","231854","210","233615","0.02"
"2025-09-21T20:46:55.529Z","Included","claude-4-sonnet-thinking","Yes","388","399","231466","170","232423","0.02"
"2025-09-21T20:46:20.385Z","Included","claude-4-sonnet-thinking","Yes","1513","39","172226","1183","174961","0.02"
"2025-09-21T20:45:54.802Z","Included","claude-4-sonnet-thinking","Yes","307","381","231159","238","232085","0.02"
"2025-09-21T20:45:39.853Z","Included","claude-4-sonnet-thinking","Yes","697","381","230462","161","231701","0.02"
"2025-09-21T20:45:27.451Z","Included","claude-4-sonnet-thinking","Yes","1062","0","229400","134","230596","0.02"
"2025-09-21T20:45:12.295Z","Included","claude-4-sonnet-thinking","Yes","4163","385","225237","615","230400","0.02"
"2025-09-21T20:44:58.400Z","Included","claude-4-sonnet-thinking","Yes","693","380","224544","158","225775","0.02"
"2025-09-21T20:44:48.026Z","Included","claude-4-sonnet-thinking","Yes","925","1","223619","133","224678","0.02"
"2025-09-21T20:44:33.222Z","Included","claude-4-sonnet-thinking","Yes","4154","386","219465","523","224528","0.02"
"2025-09-21T20:44:19.887Z","Included","claude-4-sonnet-thinking","Yes","693","384","218772","158","220007","0.02"
"2025-09-21T20:44:10.519Z","Included","claude-4-sonnet-thinking","Yes","851","4","217921","134","218910","0.02"
"2025-09-21T20:44:03.658Z","Included","claude-4-sonnet-thinking","Yes","419","4","217502","408","218333","0.02"
"2025-09-21T20:43:49.319Z","Included","claude-4-sonnet-thinking","Yes","4225","386","213277","159","218047","0.02"
"2025-09-21T20:43:40.417Z","Included","claude-4-sonnet-thinking","Yes","341","400","212936","158","213835","0.02"
"2025-09-21T20:43:28.067Z","Included","claude-4-sonnet-thinking","Yes","353","10","173349","651","174363","0.02"
"2025-09-21T20:43:18.099Z","Included","claude-4-sonnet-thinking","Yes","1123","10","172226","163","173522","0.01"
"2025-09-21T20:43:04.282Z","Included","claude-4-sonnet-thinking","Yes","161715","49","10511","773","173048","0.15"
"2025-09-21T20:42:42.041Z","Included","claude-4-sonnet-thinking","Yes","423","393","212513","224","213553","0.02"
"2025-09-21T20:41:43.450Z","Included","claude-4-sonnet-thinking","Yes","310","385","212203","220","213118","0.02"
"2025-09-21T20:41:28.380Z","Included","claude-4-sonnet-thinking","Yes","708","388","211495","163","212754","0.02"
"2025-09-21T20:41:17.639Z","Included","claude-4-sonnet-thinking","Yes","999","9","210496","142","211646","0.02"
"2025-09-21T20:41:08.905Z","Included","claude-4-sonnet-thinking","Yes","549","10","209947","475","210981","0.02"
"2025-09-21T20:39:44.874Z","Included","claude-4-sonnet-thinking","Yes","199436","301982","10511","13635","525564","0.20"
"2025-09-21T20:39:24.263Z","Included","claude-4-sonnet-thinking","Yes","712","386","555610","162","556870","0.04"
"2025-09-21T20:39:08.667Z","Included","claude-4-sonnet-thinking","Yes","831","0","554779","141","555751","0.04"
"2025-09-21T20:38:48.698Z","Included","claude-4-sonnet-thinking","Yes","4706","387","550073","464","555630","0.05"
"2025-09-21T20:38:28.621Z","Included","claude-4-sonnet-thinking","Yes","716","381","549357","169","550623","0.04"
"2025-09-21T20:38:05.084Z","Included","claude-4-sonnet-thinking","Yes","880","0","548477","147","549504","0.04"
"2025-09-21T20:37:52.314Z","Included","claude-4-sonnet-thinking","Yes","435","0","548042","508","548985","0.04"
"2025-09-21T20:37:41.011Z","Included","claude-4-sonnet-thinking","Yes","214","0","547828","141","548183","0.04"
"2025-09-21T20:37:21.475Z","Included","claude-4-sonnet-thinking","Yes","4576","384","543252","152","548364","0.04"
"2025-09-21T20:37:06.134Z","Included","claude-4-sonnet-thinking","Yes","382","400","542870","163","543815","0.04"
"2025-09-21T20:36:00.496Z","Included","claude-4-sonnet-thinking","Yes","349","387","542521","266","543523","0.04"
"2025-09-21T20:35:38.430Z","Included","claude-4-sonnet-thinking","Yes","4726","379","537795","262","543162","0.04"
"2025-09-21T20:35:25.654Z","Included","claude-4-sonnet-thinking","Yes","722","0","537073","139","537934","0.04"
"2025-09-21T20:35:12.273Z","Included","claude-4-sonnet-thinking","Yes","520","1","536553","379","537453","0.04"
"2025-09-21T20:34:50.177Z","Included","claude-4-sonnet-thinking","Yes","4753","386","531800","289","537228","0.04"
"2025-09-21T20:34:26.055Z","Included","claude-4-sonnet-thinking","Yes","2171","2","529629","165","531967","0.04"
"2025-09-21T20:34:04.911Z","Included","claude-4-sonnet-thinking","Yes","4541","383","525088","1354","531366","0.05"
"2025-09-21T20:33:43.451Z","Included","claude-4-sonnet-thinking","Yes","2158","4","522930","157","525249","0.04"
"2025-09-21T20:33:18.957Z","Included","claude-4-sonnet-thinking","Yes","235","373","522695","1295","524598","0.04"
"2025-09-21T20:33:07.903Z","Errored, Not Charged","claude-4-sonnet-thinking","Yes","206","6","522489","129","522830","0.04"
"2025-09-21T20:32:54.267Z","Included","claude-4-sonnet-thinking","Yes","774","7","521715","238","522734","0.04"
"2025-09-21T20:32:51.745Z","Included","claude-4-sonnet-thinking","Yes","344","11","173410","455","174220","0.01"
"2025-09-21T20:32:44.960Z","Included","claude-4-sonnet-thinking","Yes","594","11","172816","152","173573","0.01"
"2025-09-21T20:32:39.386Z","Included","claude-4-sonnet-thinking","Yes","523","7","521192","352","522074","0.04"
"2025-09-21T20:32:32.622Z","Included","claude-4-sonnet-thinking","Yes","870","11","171946","438","173265","0.01"
"2025-09-21T20:32:26.822Z","Included","claude-4-sonnet-thinking","Yes","611","7","520581","233","521432","0.04"
"2025-09-21T20:32:17.080Z","Included","claude-4-sonnet-thinking","Yes","1629","11","170317","656","172613","0.02"
"2025-09-21T20:32:12.099Z","Included","claude-4-sonnet-thinking","Yes","686","7","519895","392","520980","0.04"
"2025-09-21T20:31:58.908Z","Included","claude-4-sonnet-thinking","Yes","363","7","519532","253","520155","0.04"
"2025-09-21T20:31:43.221Z","Included","claude-4-sonnet-thinking","Yes","159806","87","10511","1363","171767","0.15"
"2025-09-21T20:31:38.841Z","Included","claude-4-sonnet-thinking","Yes","4541","389","514991","210","520131","0.04"
"2025-09-21T20:31:23.345Z","Included","claude-4-sonnet-thinking","Yes","964","8","514027","143","515142","0.04"
"2025-09-21T20:31:03.040Z","Included","claude-4-sonnet-thinking","Yes","4550","392","509477","586","515005","0.04"
"2025-09-21T20:30:50.625Z","Included","claude-4-sonnet-thinking","Yes","583","9","508894","152","509638","0.04"
"2025-09-21T20:30:38.016Z","Included","claude-4-sonnet-thinking","Yes","515","9","508379","317","509220","0.04"
"2025-09-21T20:30:25.572Z","Included","claude-4-sonnet-thinking","Yes","437","9","507942","279","508667","0.04"
"2025-09-21T20:30:10.898Z","Included","claude-4-sonnet-thinking","Yes","548","407","507394","209","508558","0.04"
"2025-09-21T20:29:52.258Z","Included","claude-4-sonnet-thinking","Yes","536","393","506858","194","507981","0.04"
"2025-09-21T20:29:30.591Z","Included","claude-4-sonnet-thinking","Yes","496347","63","10511","287","507208","0.45"
"2025-09-21T20:27:11.220Z","Included","claude-4-sonnet-thinking","Yes","722","600","511866","1029","514217","0.04"
"2025-09-21T20:26:47.929Z","Included","claude-4-sonnet-thinking","Yes","4706","381","507160","595","512842","0.04"
"2025-09-21T20:26:36.701Z","Included","claude-4-sonnet-thinking","Yes","440","0","506720","169","507329","0.04"
"2025-09-21T20:26:26.101Z","Included","claude-4-sonnet-thinking","Yes","543","0","506177","222","506942","0.04"
"2025-09-21T20:26:14.819Z","Included","claude-4-sonnet-thinking","Yes","471","0","505706","234","506411","0.04"
"2025-09-21T20:26:03.571Z","Included","claude-4-sonnet-thinking","Yes","842","0","504864","212","505918","0.04"
"2025-09-21T20:25:51.306Z","Included","claude-4-sonnet-thinking","Yes","592","0","504272","252","505116","0.04"
"2025-09-21T20:25:40.191Z","Included","claude-4-sonnet-thinking","Yes","682","0","503590","221","504493","0.04"
"2025-09-21T20:25:28.852Z","Included","claude-4-sonnet-thinking","Yes","456","0","503134","240","503830","0.04"
"2025-09-21T20:25:18.589Z","Included","claude-4-sonnet-thinking","Yes","240","0","502894","148","503282","0.04"
"2025-09-21T20:25:08.509Z","Included","claude-4-sonnet-thinking","Yes","587","0","502307","169","503063","0.04"
"2025-09-21T20:24:58.962Z","Included","claude-4-sonnet-thinking","Yes","361","0","501946","148","502455","0.04"
"2025-09-21T20:24:49.114Z","Included","claude-4-sonnet-thinking","Yes","352","0","501594","169","502115","0.04"
"2025-09-21T20:24:39.290Z","Included","claude-4-sonnet-thinking","Yes","200","0","501394","160","501754","0.04"
"2025-09-21T20:24:29.721Z","Included","claude-4-sonnet-thinking","Yes","184","0","501210","123","501517","0.04"
"2025-09-21T20:24:19.189Z","Included","claude-4-sonnet-thinking","Yes","569","0","500641","148","501358","0.04"
"2025-09-21T20:24:09.447Z","Included","claude-4-sonnet-thinking","Yes","542","0","500099","150","500791","0.04"
"2025-09-21T20:23:59.774Z","Included","claude-4-sonnet-thinking","Yes","400","0","499699","158","500257","0.04"
"2025-09-21T20:23:50.184Z","Included","claude-4-sonnet-thinking","Yes","219","0","499480","155","499854","0.04"
"2025-09-21T20:23:32.027Z","Included","claude-4-sonnet-thinking","Yes","4684","383","494796","162","500025","0.04"
"2025-09-21T20:23:19.246Z","Included","claude-4-sonnet-thinking","Yes","331","402","494465","157","495355","0.04"
"2025-09-21T20:22:23.621Z","Included","claude-4-sonnet-thinking","Yes","458","401","494007","214","495080","0.04"
"2025-09-21T20:21:21.910Z","Included","claude-4-sonnet-thinking","Yes","302","378","493705","209","494594","0.04"
"2025-09-21T20:21:04.551Z","Included","claude-4-sonnet-thinking","Yes","702","379","493003","156","494240","0.04"
"2025-09-21T20:20:52.477Z","Included","claude-4-sonnet-thinking","Yes","752","0","492251","145","493148","0.04"
"2025-09-21T20:20:33.926Z","Included","claude-4-sonnet-thinking","Yes","4201","382","488050","337","492970","0.04"
"2025-09-21T20:20:20.875Z","Included","claude-4-sonnet-thinking","Yes","308","395","487742","156","488601","0.04"
"2025-09-21T20:19:20.160Z","Included","claude-4-sonnet-thinking","Yes","504","390","487238","194","488326","0.04"
"2025-09-21T20:18:14.805Z","Included","claude-4-sonnet-thinking","Yes","309","381","486929","302","487921","0.04"
"2025-09-21T20:17:56.641Z","Included","claude-4-sonnet-thinking","Yes","2298","506","484631","163","487598","0.04"
"2025-09-21T20:17:39.353Z","Included","claude-4-sonnet-thinking","Yes","705","380","483926","293","485304","0.04"
"2025-09-21T20:17:29.191Z","Included","claude-4-sonnet-thinking","Yes","368","0","483558","146","484072","0.04"
"2025-09-21T20:17:19.814Z","Included","claude-4-sonnet-thinking","Yes","247","0","483311","189","483747","0.04"
"2025-09-21T20:17:02.796Z","Included","claude-4-sonnet-thinking","Yes","4511","380","478800","135","483826","0.04"
"2025-09-21T20:16:48.715Z","Included","claude-4-sonnet-thinking","Yes","1186","0","477614","154","478954","0.04"
"2025-09-21T20:16:37.658Z","Included","claude-4-sonnet-thinking","Yes","419","0","477195","502","478116","0.04"
"2025-09-21T20:16:19.920Z","Included","claude-4-sonnet-thinking","Yes","4158","383","473037","218","477796","0.04"
"2025-09-21T20:16:03.134Z","Included","claude-4-sonnet-thinking","Yes","733","384","472304","157","473578","0.04"
"2025-09-21T20:15:52.592Z","Included","claude-4-sonnet-thinking","Yes","442","0","471862","171","472475","0.03"
"2025-09-21T20:15:41.005Z","Included","claude-4-sonnet-thinking","Yes","405","0","471457","262","472124","0.04"
"2025-09-21T20:15:23.043Z","Included","claude-4-sonnet-thinking","Yes","1099","383","470358","207","472047","0.04"
"2025-09-21T20:15:06.357Z","Included","claude-4-sonnet-thinking","Yes","1484","0","468874","179","470537","0.04"
"2025-09-21T20:14:55.127Z","Included","claude-4-sonnet-thinking","Yes","376","0","468498","839","469713","0.04"
"2025-09-21T20:14:36.366Z","Included","claude-4-sonnet-thinking","Yes","1058","385","467440","188","469071","0.04"
"2025-09-21T20:14:26.372Z","Included","claude-4-sonnet-thinking","Yes","396","0","467044","152","467592","0.03"
"2025-09-21T20:14:16.701Z","Included","claude-4-sonnet-thinking","Yes","411","0","466633","216","467260","0.03"
"2025-09-21T20:14:02.201Z","Included","claude-4-sonnet-thinking","Yes","1252","0","465381","149","466782","0.04"
"2025-09-21T20:13:44.510Z","Included","claude-4-sonnet-thinking","Yes","1056","384","464325","676","466441","0.04"
"2025-09-21T20:13:27.745Z","Included","claude-4-sonnet-thinking","Yes","703","382","463622","160","464867","0.03"
"2025-09-21T20:13:15.960Z","Included","claude-4-sonnet-thinking","Yes","965","0","462657","147","463769","0.03"
"2025-09-21T20:13:06.714Z","Included","claude-4-sonnet-thinking","Yes","410","0","462247","403","463060","0.04"
"2025-09-21T20:12:53.833Z","Errored, Not Charged","claude-4-sonnet-thinking","Yes","586","0","461661","131","462378","0.03"
"2025-09-21T20:12:44.582Z","Included","claude-4-sonnet-thinking","Yes","460","0","461201","515","462176","0.04"
"2025-09-21T20:12:27.183Z","Included","claude-4-sonnet-thinking","Yes","4201","383","457000","168","461752","0.04"
"2025-09-21T20:12:14.141Z","Included","claude-4-sonnet-thinking","Yes","370","394","456630","157","457551","0.03"
"2025-09-21T20:11:13.259Z","Included","claude-4-sonnet-thinking","Yes","316","380","456314","224","457234","0.03"
"2025-09-21T20:11:03.406Z","Included","claude-4-sonnet-thinking","Yes","483","0","455831","154","456468","0.03"
"2025-09-21T20:10:50.450Z","Included","claude-4-sonnet-thinking","Yes","758","384","455073","235","456450","0.03"
"2025-09-21T20:10:34.094Z","Included","claude-4-sonnet-thinking","Yes","694","381","454379","165","455619","0.03"
"2025-09-21T20:10:21.704Z","Included","claude-4-sonnet-thinking","Yes","714","0","453665","169","454548","0.03"
"2025-09-21T20:10:11.808Z","Included","claude-4-sonnet-thinking","Yes","663","0","453002","371","454036","0.03"
"2025-09-21T20:09:59.767Z","Included","claude-4-sonnet-thinking","Yes","660","0","452342","355","453357","0.03"
"2025-09-21T20:09:47.992Z","Included","claude-4-sonnet-thinking","Yes","578","0","451764","335","452677","0.03"
"2025-09-21T20:09:38.233Z","Included","claude-4-sonnet-thinking","Yes","514","0","451250","270","452034","0.03"
"2025-09-21T20:09:25.768Z","Included","claude-4-sonnet-thinking","Yes","361","0","450889","294","451544","0.03"
"2025-09-21T20:09:08.558Z","Included","claude-4-sonnet-thinking","Yes","4455","382","446434","187","451458","0.04"
"2025-09-21T20:08:52.567Z","Included","claude-4-sonnet-thinking","Yes","673","382","445761","160","446976","0.03"
"2025-09-21T20:08:42.282Z","Included","claude-4-sonnet-thinking","Yes","590","0","445171","143","445904","0.03"
"2025-09-21T20:08:25.725Z","Included","claude-4-sonnet-thinking","Yes","4550","386","440621","274","445831","0.04"
"2025-09-21T20:08:13.549Z","Included","claude-4-sonnet-thinking","Yes","298","390","440323","156","441167","0.03"
"2025-09-21T20:08:00.052Z","Included","claude-4-sonnet-thinking","Yes","321","391","440002","196","440910","0.03"
"2025-09-21T20:07:44.179Z","Included","claude-4-sonnet-thinking","Yes","675","381","439327","183","440566","0.03"
"2025-09-21T20:07:33.508Z","Included","claude-4-sonnet-thinking","Yes","447","0","438880","151","439478","0.03"
"2025-09-21T20:07:22.627Z","Included","claude-4-sonnet-thinking","Yes","637","0","438243","220","439100","0.03"
"2025-09-21T20:07:10.155Z","Included","claude-4-sonnet-thinking","Yes","625","0","437618","346","438589","0.03"
"2025-09-21T20:07:00.369Z","Included","claude-4-sonnet-thinking","Yes","498","0","437120","334","437952","0.03"
"2025-09-21T20:06:50.291Z","Included","claude-4-sonnet-thinking","Yes","454","0","436666","231","437351","0.03"
"2025-09-21T20:06:37.087Z","Included","claude-4-sonnet-thinking","Yes","867","0","435799","198","436864","0.03"
"2025-09-21T20:06:18.525Z","Included","claude-4-sonnet-thinking","Yes","8812","380","426987","506","436685","0.04"
"2025-09-21T20:06:03.978Z","Included","claude-4-sonnet-thinking","Yes","1232","0","425755","156","427143","0.03"
"2025-09-21T20:05:46.870Z","Included","claude-4-sonnet-thinking","Yes","8786","383","416969","663","426801","0.04"
"2025-09-21T20:05:30.519Z","Included","claude-4-sonnet-thinking","Yes","680","383","416289","152","417504","0.03"
"2025-09-21T20:05:20.507Z","Included","claude-4-sonnet-thinking","Yes","486","0","415803","150","416439","0.03"
"2025-09-21T20:05:10.743Z","Errored, Not Charged","claude-4-sonnet-thinking","Yes","277","0","415526","238","416041","0.03"
"2025-09-21T20:04:54.338Z","Included","claude-4-sonnet-thinking","Yes","4511","385","411015","202","416113","0.03"
"2025-09-21T20:04:37.594Z","Included","claude-4-sonnet-thinking","Yes","688","383","410327","155","411553","0.03"
"2025-09-21T20:04:26.864Z","Included","claude-4-sonnet-thinking","Yes","531","0","409796","155","410482","0.03"
"2025-09-21T20:04:11.638Z","Included","claude-4-sonnet-thinking","Yes","4533","385","405263","268","410449","0.03"
"2025-09-21T20:03:54.148Z","Included","claude-4-sonnet-thinking","Yes","676","381","404587","162","405806","0.03"
"2025-09-21T20:03:43.168Z","Included","claude-4-sonnet-thinking","Yes","624","0","403963","150","404737","0.03"
"2025-09-21T20:03:34.457Z","Included","claude-4-sonnet-thinking","Yes","463","0","403500","306","404269","0.03"
"2025-09-21T20:03:18.635Z","Included","claude-4-sonnet-thinking","Yes","4514","383","398986","216","404099","0.03"
"2025-09-21T20:03:02.690Z","Included","claude-4-sonnet-thinking","Yes","706","383","398280","158","399527","0.03"
"2025-09-21T20:02:50.168Z","Included","claude-4-sonnet-thinking","Yes","1087","1","397193","175","398456","0.03"
"2025-09-21T20:02:40.424Z","Included","claude-4-sonnet-thinking","Yes","426","1","396767","651","397845","0.03"
"2025-09-21T20:02:25.554Z","Errored, Not Charged","claude-4-sonnet-thinking","Yes","1020","1","395747","208","396976","0.03"
"2025-09-21T20:02:16.474Z","Included","claude-4-sonnet-thinking","Yes","438","1","395309","556","396304","0.03"
"2025-09-21T20:01:58.875Z","Included","claude-4-sonnet-thinking","Yes","4483","383","390826","233","395925","0.03"
"2025-09-21T20:01:47.638Z","Included","claude-4-sonnet-thinking","Yes","337","396","390489","170","391392","0.03"
"2025-09-21T20:01:31.365Z","Included","claude-4-sonnet-thinking","Yes","671","384","389818","184","391057","0.03"
"2025-09-21T20:01:21.330Z","Included","claude-4-sonnet-thinking","Yes","608","4","389210","144","389966","0.03"
"2025-09-21T20:01:12.194Z","Included","claude-4-sonnet-thinking","Yes","407","5","388803","359","389574","0.03"
"2025-09-21T20:01:03.676Z","Included","claude-4-sonnet-thinking","Yes","225","5","388578","175","388983","0.03"
"2025-09-21T20:00:47.392Z","Included","claude-4-sonnet-thinking","Yes","4909","392","383669","161","389131","0.03"
"2025-09-21T20:00:31.162Z","Included","claude-4-sonnet-thinking","Yes","681","390","382988","156","384215","0.03"
"2025-09-21T20:00:20.729Z","Included","claude-4-sonnet-thinking","Yes","669","8","382319","149","383145","0.03"
"2025-09-21T20:00:03.203Z","Included","claude-4-sonnet-thinking","Yes","4533","396","377786","361","383076","0.03"
"2025-09-21T19:59:50.716Z","Included","claude-4-sonnet-thinking","Yes","558","411","377228","167","378364","0.03"
"2025-09-21T19:59:41.883Z","Included","claude-4-sonnet-thinking","Yes","383","48","376845","277","377553","0.03"
"2025-09-21T19:59:34.622Z","Errored, Not Charged","claude-4-sonnet-thinking","No","0","387","0","10","397","0.000"
"2025-09-21T19:59:15.066Z","Errored, Not Charged","claude-4-sonnet-thinking","Yes","223","408","377395","169","378195","0.03"
"2025-09-21T19:59:03.691Z","Included","claude-4-sonnet-thinking","Yes","550","10","376845","193","377598","0.03"
"2025-09-21T19:58:48.447Z","Included","claude-4-sonnet-thinking","Yes","366334","28","10511","475","377348","0.33"
"2025-09-21T19:58:12.695Z","Included","claude-4-sonnet-thinking","Yes","2087","11","169481","636","172215","0.02"
"2025-09-21T19:57:27.522Z","Included","claude-4-sonnet-thinking","Yes","158970","93","10511","1814","171388","0.15"
"2025-09-21T19:55:57.611Z","Included","claude-4-sonnet-thinking","Yes","553","397","377991","2106","381047","0.04"
"2025-09-21T19:55:44.356Z","Included","claude-4-sonnet-thinking","Yes","609","474","377382","185","378650","0.03"
"2025-09-21T19:54:42.560Z","Included","claude-4-sonnet-thinking","Yes","302","381","377080","285","378048","0.03"
"2025-09-21T19:54:26.461Z","Included","claude-4-sonnet-thinking","Yes","712","381","376368","156","377617","0.03"
"2025-09-21T19:54:17.725Z","Included","claude-4-sonnet-thinking","Yes","399","0","375969","140","376508","0.03"
"2025-09-21T19:54:01.753Z","Included","claude-4-sonnet-thinking","Yes","4615","381","371354","203","376553","0.03"
"2025-09-21T19:53:53.842Z","Included","claude-4-sonnet-thinking","Yes","365","0","370989","141","371495","0.03"
"2025-09-21T19:53:45.394Z","Included","claude-4-sonnet-thinking","Yes","458","0","370531","183","371172","0.03"
"2025-09-21T19:53:37.993Z","Included","claude-4-sonnet-thinking","Yes","197","0","370334","117","370648","0.03"
"2025-09-21T19:53:30.384Z","Included","claude-4-sonnet-thinking","Yes","555","0","369779","125","370459","0.03"
"2025-09-21T19:53:15.379Z","Included","claude-4-sonnet-thinking","Yes","4699","386","365080","162","370327","0.03"
"2025-09-21T19:52:13.175Z","Included","claude-4-sonnet-thinking","Yes","300","380","364780","231","365691","0.03"
"2025-09-21T19:51:57.382Z","Included","claude-4-sonnet-thinking","Yes","626","385","364154","154","365319","0.03"
"2025-09-21T19:51:49.098Z","Included","claude-4-sonnet-thinking","Yes","366","0","363788","142","364296","0.03"
"2025-09-21T19:51:41.313Z","Included","claude-4-sonnet-thinking","Yes","388","0","363400","173","363961","0.03"
"2025-09-21T19:51:34.108Z","Included","claude-4-sonnet-thinking","Yes","228","0","363172","177","363577","0.03"
"2025-09-21T19:51:26.774Z","Included","claude-4-sonnet-thinking","Yes","570","0","362602","116","363288","0.03"
"2025-09-21T19:51:11.127Z","Included","claude-4-sonnet-thinking","Yes","4332","387","358270","161","363150","0.03"
"2025-09-21T19:50:10.059Z","Included","claude-4-sonnet-thinking","Yes","340","391","357930","170","358831","0.03"
"2025-09-21T19:49:59.735Z","Included","claude-4-sonnet-thinking","Yes","427","374","357503","180","358484","0.03"
"2025-09-21T19:49:46.088Z","Included","claude-4-sonnet-thinking","Yes","2060","467","355443","151","358121","0.03"
"2025-09-21T19:48:46.473Z","Included","claude-4-sonnet-thinking","Yes","317","380","355126","270","356093","0.03"
"2025-09-21T19:48:30.855Z","Included","claude-4-sonnet-thinking","Yes","693","380","354433","165","355671","0.03"
"2025-09-21T19:48:20.790Z","Included","claude-4-sonnet-thinking","Yes","700","0","353733","135","354568","0.03"
"2025-09-21T19:48:12.203Z","Included","claude-4-sonnet-thinking","Yes","525","0","353208","338","354071","0.03"
"2025-09-21T19:47:57.210Z","Included","claude-4-sonnet-thinking","Yes","4228","384","348980","176","353768","0.03"
"2025-09-21T19:47:43.864Z","Included","claude-4-sonnet-thinking","Yes","350","393","348630","166","349539","0.03"
"2025-09-21T19:47:31.127Z","Included","claude-4-sonnet-thinking","Yes","318","388","348312","203","349221","0.03"
"2025-09-21T19:47:14.804Z","Included","claude-4-sonnet-thinking","Yes","660","379","347652","180","348871","0.03"
"2025-09-21T19:47:05.862Z","Included","claude-4-sonnet-thinking","Yes","520","0","347132","134","347786","0.03"
"2025-09-21T19:46:57.628Z","Included","claude-4-sonnet-thinking","Yes","448","0","346684","247","347379","0.03"
"2025-09-21T19:46:42.330Z","Included","claude-4-sonnet-thinking","Yes","4489","384","342195","202","347270","0.03"
"2025-09-21T19:46:26.994Z","Included","claude-4-sonnet-thinking","Yes","662","380","341533","157","342732","0.03"
"2025-09-21T19:46:18.004Z","Included","claude-4-sonnet-thinking","Yes","584","0","340949","135","341668","0.03"
"2025-09-21T19:46:08.756Z","Included","claude-4-sonnet-thinking","Yes","570","0","340379","229","341178","0.03"
"2025-09-21T19:46:00.376Z","Included","claude-4-sonnet-thinking","Yes","518","0","339861","264","340643","0.03"
"2025-09-21T19:45:43.773Z","Included","claude-4-sonnet-thinking","Yes","4451","379","335410","272","340512","0.03"
"2025-09-21T19:45:33.798Z","Included","claude-4-sonnet-thinking","Yes","695","0","334715","134","335544","0.03"
"2025-09-21T19:45:19.107Z","Included","claude-4-sonnet-thinking","Yes","5975","383","328740","319","335417","0.03"
"2025-09-21T19:45:04.739Z","Included","claude-4-sonnet-thinking","Yes","663","381","328077","156","329277","0.02"
"2025-09-21T19:44:55.305Z","Included","claude-4-sonnet-thinking","Yes","679","0","327398","137","328214","0.02"
"2025-09-21T19:44:47.503Z","Included","claude-4-sonnet-thinking","Yes","509","0","326889","349","327747","0.03"
"2025-09-21T19:44:30.766Z","Included","claude-4-sonnet-thinking","Yes","4400","380","322489","171","327440","0.03"
"2025-09-21T19:44:21.603Z","Included","claude-4-sonnet-thinking","Yes","649","0","321840","138","322627","0.02"
"2025-09-21T19:44:05.112Z","Included","claude-4-sonnet-thinking","Yes","5967","384","315873","341","322565","0.03"
"2025-09-21T19:43:56.377Z","Included","claude-4-sonnet-thinking","Yes","566","1","315307","140","316014","0.02"
"2025-09-21T19:43:40.848Z","Included","claude-4-sonnet-thinking","Yes","6000","384","309307","276","315967","0.03"
"2025-09-21T19:43:25.045Z","Included","claude-4-sonnet-thinking","Yes","4422","385","304885","183","309875","0.03"
"2025-09-21T19:43:15.006Z","Included","claude-4-sonnet-thinking","Yes","993","3","303892","143","305031","0.02"
"2025-09-21T19:43:04.238Z","Included","claude-4-sonnet-thinking","Yes","713","3","303179","451","304346","0.02"
"2025-09-21T19:42:47.693Z","Included","claude-4-sonnet-thinking","Yes","4420","383","298759","495","304057","0.03"
"2025-09-21T19:42:37.354Z","Included","claude-4-sonnet-thinking","Yes","1069","4","297690","141","298904","0.02"
"2025-09-21T19:42:27.791Z","Included","claude-4-sonnet-thinking","Yes","434","4","297256","531","298225","0.02"
"2025-09-21T19:42:12.503Z","Included","claude-4-sonnet-thinking","Yes","4428","387","292828","176","297819","0.03"
"2025-09-21T19:42:01.689Z","Included","claude-4-sonnet-thinking","Yes","627","5","292201","149","292982","0.02"
"2025-09-21T19:41:46.453Z","Included","claude-4-sonnet-thinking","Yes","4432","386","287769","362","292949","0.03"
"2025-09-21T19:41:32.278Z","Included","claude-4-sonnet-thinking","Yes","682","392","287087","163","288324","0.02"
"2025-09-21T19:41:23.475Z","Included","claude-4-sonnet-thinking","Yes","621","8","286466","150","287245","0.02"
"2025-09-21T19:41:08.987Z","Included","claude-4-sonnet-thinking","Yes","4542","396","281924","316","287178","0.03"
"2025-09-21T19:40:57.522Z","Included","claude-4-sonnet-thinking","Yes","469","408","281455","180","282512","0.02"
"2025-09-21T19:40:49.836Z","Included","claude-4-sonnet-thinking","Yes","366","42","281089","277","281774","0.02"
"2025-09-21T19:40:28.496Z","Errored, Not Charged","claude-4-sonnet-thinking","No","0","398","0","10","408","0.000"
"2025-09-21T19:40:20.117Z","Included","claude-4-sonnet-thinking","Yes","548","10","281089","179","281826","0.02"
"2025-09-21T19:39:54.144Z","Included","claude-4-sonnet-thinking","Yes","270578","32","10511","469","281590","0.25"
"2025-09-21T19:38:24.664Z","Included","claude-4-sonnet-thinking","Yes","425","382","284452","987","286246","0.02"
"2025-09-21T19:38:11.367Z","Included","claude-4-sonnet-thinking","Yes","405","492","284047","149","285093","0.02"
"2025-09-21T19:37:46.716Z","Included","claude-4-sonnet-thinking","Yes","1988","381","282059","280","284708","0.02"
"2025-09-21T19:37:39.915Z","Included","claude-4-sonnet-thinking","Yes","383","0","281676","136","282195","0.02"
"2025-09-21T19:37:27.401Z","Included","claude-4-sonnet-thinking","Yes","402","379","281274","170","282225","0.02"
"2025-09-21T19:37:19.661Z","Included","claude-4-sonnet-thinking","Yes","567","0","280707","139","281413","0.02"
"2025-09-21T19:36:07.546Z","Included","claude-4-sonnet-thinking","Yes","320","383","280387","340","281430","0.02"
"2025-09-21T19:35:52.856Z","Included","claude-4-sonnet-thinking","Yes","1049","387","279338","174","280948","0.02"
"2025-09-21T19:35:45.986Z","Included","claude-4-sonnet-thinking","Yes","375","0","278963","151","279489","0.02"
"2025-09-21T19:35:39.347Z","Included","claude-4-sonnet-thinking","Yes","423","0","278540","172","279135","0.02"
"2025-09-21T19:35:23.961Z","Included","claude-4-sonnet-thinking","Yes","8940","389","269600","224","279153","0.03"
"2025-09-21T19:34:34.029Z","Included","claude-4-sonnet-thinking","Yes","569","389","269031","175","270164","0.02"
"2025-09-21T19:34:24.340Z","Included","claude-4-sonnet-thinking","Yes","731","388","268300","176","269595","0.02"
"2025-09-21T19:33:21.400Z","Included","claude-4-sonnet-thinking","Yes","393","386","267907","375","269061","0.02"
"2025-09-21T19:33:06.688Z","Included","claude-4-sonnet-thinking","Yes","677","388","267230","247","268542","0.02"
"2025-09-21T19:33:00.069Z","Included","claude-4-sonnet-thinking","Yes","451","0","266779","154","267384","0.02"
"2025-09-21T19:32:45.881Z","Included","claude-4-sonnet-thinking","Yes","317","388","266462","222","267389","0.02"
"2025-09-21T19:32:32.390Z","Included","claude-4-sonnet-thinking","Yes","710","384","265752","179","267025","0.02"
"2025-09-21T19:32:24.273Z","Included","claude-4-sonnet-thinking","Yes","443","0","265309","149","265901","0.02"
"2025-09-21T19:32:10.232Z","Included","claude-4-sonnet-thinking","Yes","4308","382","261001","256","265947","0.02"
"2025-09-21T19:32:03.615Z","Included","claude-4-sonnet-thinking","Yes","437","0","260564","147","261148","0.02"
"2025-09-21T19:31:55.217Z","Errored, Not Charged","claude-4-sonnet-thinking","Yes","539","0","260025","204","260768","0.02"
"2025-09-21T19:31:49.491Z","Included","claude-4-sonnet-thinking","Yes","337","0","259688","343","260368","0.02"
"2025-09-21T19:31:41.989Z","Included","claude-4-sonnet-thinking","Yes","512","0","259176","163","259851","0.02"
"2025-09-21T19:31:35.254Z","Included","claude-4-sonnet-thinking","Yes","725","0","258451","135","259311","0.02"
"2025-09-21T19:31:21.371Z","Included","claude-4-sonnet-thinking","Yes","4329","385","254122","173","259009","0.02"
"2025-09-21T19:31:11.114Z","Included","claude-4-sonnet-thinking","Yes","649","386","253473","180","254688","0.02"
"2025-09-21T19:31:03.686Z","Included","claude-4-sonnet-thinking","Yes","462","0","253011","156","253629","0.02"
"2025-09-21T19:30:52.002Z","Included","claude-4-sonnet-thinking","Yes","328","391","252683","233","253635","0.02"
"2025-09-21T19:30:37.976Z","Included","claude-4-sonnet-thinking","Yes","676","382","252007","190","253255","0.02"
"2025-09-21T19:30:31.046Z","Included","claude-4-sonnet-thinking","Yes","507","0","251500","150","252157","0.02"
"2025-09-21T19:30:14.338Z","Included","claude-4-sonnet-thinking","Yes","9645","389","241855","289","252178","0.03"
"2025-09-21T19:30:05.936Z","Included","claude-4-sonnet-thinking","Yes","540","0","241315","145","242000","0.02"
"2025-09-21T19:29:59.031Z","Included","claude-4-sonnet-thinking","Yes","474","0","240841","292","241607","0.02"
"2025-09-21T19:29:42.206Z","Included","claude-4-sonnet-thinking","Yes","9766","392","231075","256","241489","0.03"
"2025-09-21T19:29:31.627Z","Included","claude-4-sonnet-thinking","Yes","899","0","230176","149","231224","0.02"
"2025-09-21T19:29:24.490Z","Included","claude-4-sonnet-thinking","Yes","373","0","229803","447","230623","0.02"
"2025-09-21T19:29:16.228Z","Included","claude-4-sonnet-thinking","Yes","466","0","229337","170","229973","0.02"
"2025-09-21T19:29:06.880Z","Included","claude-4-sonnet-thinking","Yes","785","0","228552","223","229560","0.02"
"2025-09-21T19:29:00.331Z","Included","claude-4-sonnet-thinking","Yes","556","0","227996","458","229010","0.02"
"2025-09-21T19:28:44.873Z","Included","claude-4-sonnet-thinking","Yes","8273","387","219723","225","228608","0.02"
"2025-09-21T19:28:29.999Z","Included","claude-4-sonnet-thinking","Yes","675","383","219048","168","220274","0.02"
"2025-09-21T19:28:21.884Z","Included","claude-4-sonnet-thinking","Yes","633","0","218415","144","219192","0.02"
"2025-09-21T19:28:10.328Z","Included","claude-4-sonnet-thinking","Yes","397","0","218018","320","218735","0.02"
"2025-09-21T19:27:55.822Z","Included","claude-4-sonnet-thinking","Yes","4519","383","213499","202","218603","0.02"
"2025-09-21T19:27:45.793Z","Included","claude-4-sonnet-thinking","Yes","418","394","213081","156","214049","0.02"
"2025-09-21T19:27:35.509Z","Included","claude-4-sonnet-thinking","Yes","435","386","212646","188","213655","0.02"
"2025-09-21T19:27:18.345Z","Included","claude-4-sonnet-thinking","Yes","245","363","212401","180","213189","0.02"
"2025-09-21T19:26:06.581Z","Included","claude-4-sonnet-thinking","Yes","5494","0","206907","140","212541","0.02"
"2025-09-21T19:25:58.797Z","Errored, Not Charged","claude-4-sonnet-thinking","Yes","355","0","206552","5454","212361","0.03"
"2025-09-21T19:25:52.327Z","Included","claude-4-sonnet-thinking","Yes","262","0","206290","208","206760","0.02"
"2025-09-21T19:25:45.733Z","Errored, Not Charged","claude-4-sonnet-thinking","Yes","246","0","206044","163","206453","0.02"
"2025-09-21T19:25:40.440Z","Included","claude-4-sonnet-thinking","Yes","362","0","205682","182","206226","0.02"
"2025-09-21T19:25:39.869Z","Included","claude-4-sonnet-thinking","Yes","574","498","169374","912","171358","0.02"
"2025-09-21T19:25:34.355Z","Errored, Not Charged","claude-4-sonnet-thinking","Yes","271","0","205411","139","205821","0.02"
"2025-09-21T19:25:33.738Z","Included","claude-4-sonnet-thinking","Yes","408","9","168966","253","169636","0.01"
"2025-09-21T19:25:27.711Z","Included","claude-4-sonnet-thinking","Yes","456","0","204955","207","205618","0.02"
"2025-09-21T19:25:25.600Z","Included","claude-4-sonnet-thinking","Yes","326","9","168640","258","169233","0.01"
"2025-09-21T19:25:20.748Z","Errored, Not Charged","claude-4-sonnet-thinking","Yes","271","0","204684","154","205109","0.02"
"2025-09-21T19:25:16.797Z","Included","claude-4-sonnet-thinking","Yes","894","9","167746","217","168866","0.01"
"2025-09-21T19:25:15.043Z","Included","claude-4-sonnet-thinking","Yes","634","0","204050","207","204891","0.02"
"2025-09-21T19:25:07.698Z","Included","claude-4-sonnet-thinking","Yes","586","9","167160","490","168245","0.01"
"2025-09-21T19:24:55.930Z","Included","claude-4-sonnet-thinking","Yes","654","374","203396","186","204610","0.02"
"2025-09-21T19:24:55.339Z","Included","claude-4-sonnet-thinking","Yes","956","9","166204","434","167603","0.01"
"2025-09-21T19:24:49.041Z","Included","claude-4-sonnet-thinking","Yes","305","9","165899","120","166333","0.01"
"2025-09-21T19:24:47.659Z","Included","claude-4-sonnet-thinking","Yes","501","0","202895","303","203699","0.02"
"2025-09-21T19:24:41.232Z","Included","claude-4-sonnet-thinking","Yes","502","0","202393","188","203083","0.02"
"2025-09-21T19:24:41.144Z","Included","claude-4-sonnet-thinking","Yes","357","10","165542","184","166093","0.01"
"2025-09-21T19:24:36.182Z","Included","claude-4-sonnet-thinking","Yes","442","0","201951","139","202532","0.02"
"2025-09-21T19:24:34.393Z","Included","claude-4-sonnet-thinking","Yes","569","11","164973","182","165735","0.01"
"2025-09-21T19:24:30.495Z","Included","claude-4-sonnet-thinking","Yes","692","0","201259","153","202104","0.02"
"2025-09-21T19:24:24.742Z","Included","claude-4-sonnet-thinking","Yes","521","11","164452","247","165231","0.01"
"2025-09-21T19:24:12.037Z","Included","claude-4-sonnet-thinking","Yes","153941","87","10511","388","164927","0.14"
"2025-09-21T19:24:11.729Z","Included","claude-4-sonnet-thinking","Yes","576","364","200683","179","201802","0.02"
"2025-09-21T19:24:04.796Z","Included","claude-4-sonnet-thinking","Yes","342","1","200341","134","200818","0.02"
"2025-09-21T19:23:59.144Z","Included","claude-4-sonnet-thinking","Yes","309","1","200032","155","200497","0.02"
"2025-09-21T19:23:42.929Z","Included","claude-4-sonnet-thinking","Yes","5294","387","194738","173","200592","0.02"
"2025-09-21T19:23:35.737Z","Included","claude-4-sonnet-thinking","Yes","513","2","194225","149","194889","0.01"
"2025-09-21T19:23:27.357Z","Included","claude-4-sonnet-thinking","Yes","887","3","193338","284","194512","0.02"
"2025-09-21T19:23:19.491Z","Included","claude-4-sonnet-thinking","Yes","392","3","192946","200","193541","0.01"
"2025-09-21T19:23:09.906Z","Included","claude-4-sonnet-thinking","Yes","620","3","192326","150","193099","0.01"
"2025-09-21T19:23:02.215Z","Included","claude-4-sonnet-thinking","Yes","601","3","191725","292","192621","0.02"
"2025-09-21T19:22:53.421Z","Included","claude-4-sonnet-thinking","Yes","586","4","191139","326","192055","0.02"
"2025-09-21T19:22:41.055Z","Included","claude-4-sonnet-thinking","Yes","980","5","190159","312","191456","0.02"
"2025-09-21T19:22:30.009Z","Included","claude-4-sonnet-thinking","Yes","1008","5","189151","574","190738","0.02"
"2025-09-21T19:22:21.729Z","Included","claude-4-sonnet-thinking","Yes","6778","5","182373","524","189680","0.02"
"2025-09-21T19:22:03.204Z","Included","claude-4-sonnet-thinking","Yes","10187","389","172186","236","182998","0.02"
"2025-09-21T19:21:55.907Z","Included","claude-4-sonnet-thinking","Yes","528","6","171658","167","172359","0.01"
"2025-09-21T19:21:48.870Z","Included","claude-4-sonnet-thinking","Yes","161147","24","10511","453","172135","0.15"
"2025-09-21T19:15:14.919Z","Included","claude-4-sonnet-thinking","Yes","506","405","171429","703","173043","0.02"
"2025-09-21T19:15:05.753Z","Included","claude-4-sonnet-thinking","Yes","935","384","170494","210","172023","0.01"
"2025-09-21T19:14:56.774Z","Included","claude-4-sonnet-thinking","Yes","398","384","170096","270","171148","0.01"
"2025-09-21T19:14:47.458Z","Included","claude-4-sonnet-thinking","Yes","412","371","169684","320","170787","0.01"
"2025-09-21T19:14:41.073Z","Included","claude-4-sonnet-thinking","Yes","297","370","169387","165","170219","0.01"
"2025-09-21T19:14:33.797Z","Included","claude-4-sonnet-thinking","Yes","253","396","169134","226","170009","0.01"
"2025-09-21T19:14:27.844Z","Included","claude-4-sonnet-thinking","Yes","279","397","168855","182","169713","0.01"
"2025-09-21T19:14:20.008Z","Included","claude-4-sonnet-thinking","Yes","331","375","168524","208","169438","0.01"
"2025-09-21T19:14:15.193Z","Included","claude-4-sonnet-thinking","Yes","1704","39","166820","164","168727","0.01"
"2025-09-21T19:09:51.789Z","Included","claude-4-sonnet-thinking","Yes","245","392","168343","410","169390","0.01"
"2025-09-21T19:09:42.152Z","Included","claude-4-sonnet-thinking","Yes","462","400","167881","162","168905","0.01"
"2025-09-21T19:09:33.554Z","Included","claude-4-sonnet-thinking","Yes","486","378","167395","349","168608","0.01"
"2025-09-21T19:09:25.743Z","Included","claude-4-sonnet-thinking","Yes","294","372","167101","190","167957","0.01"
"2025-09-21T19:09:19.256Z","Included","claude-4-sonnet-thinking","Yes","281","371","166820","167","167639","0.01"
"2025-09-21T19:09:12.511Z","Included","claude-4-sonnet-thinking","Yes","156309","30","10511","161","167011","0.14"
"2025-09-21T19:07:36.970Z","Included","claude-4-sonnet-thinking","Yes","1987","381","169271","835","172474","0.02"
"2025-09-21T19:07:24.716Z","Included","claude-4-sonnet-thinking","Yes","327","375","168944","145","169791","0.01"
"2025-09-21T19:07:17.962Z","Included","claude-4-sonnet-thinking","Yes","190","0","168754","136","169080","0.01"
"2025-09-21T19:06:19.542Z","Included","claude-4-sonnet-thinking","Yes","367","384","168387","143","169281","0.01"
"2025-09-21T19:06:07.419Z","Included","claude-4-sonnet-thinking","Yes","830","389","167557","215","168991","0.01"
"2025-09-21T19:06:00.639Z","Included","claude-4-sonnet-thinking","Yes","484","0","167073","156","167713","0.01"
"2025-09-21T19:05:49.128Z","Included","claude-4-sonnet-thinking","Yes","3190","388","163883","272","167733","0.02"
"2025-09-21T19:05:38.509Z","Included","claude-4-sonnet-thinking","Yes","907","0","162976","156","164039","0.01"
"2025-09-21T19:05:26.479Z","Included","claude-4-sonnet-thinking","Yes","5638","387","157338","560","163923","0.02"
"2025-09-21T19:05:11.477Z","Included","claude-4-sonnet-thinking","Yes","794","397","156544","185","157920","0.01"
"2025-09-21T19:05:04.387Z","Included","claude-4-sonnet-thinking","Yes","728","0","155816","166","156710","0.01"
"2025-09-21T19:04:59.651Z","Included","claude-4-sonnet-thinking","Yes","302","0","155514","366","156182","0.01"
"2025-09-21T19:04:54.753Z","Included","claude-4-sonnet-thinking","Yes","194","0","155320","128","155642","0.01"
"2025-09-21T19:04:49.942Z","Included","claude-4-sonnet-thinking","Yes","318","0","155002","118","155438","0.01"
"2025-09-21T19:04:40.069Z","Included","claude-4-sonnet-thinking","Yes","831","0","154171","143","155145","0.01"
"2025-09-21T19:04:25.532Z","Included","claude-4-sonnet-thinking","Yes","9702","391","144469","506","155068","0.02"
"2025-09-21T19:04:15.769Z","Included","claude-4-sonnet-thinking","Yes","316","389","144153","190","145048","0.01"
"2025-09-21T19:04:02.596Z","Included","claude-4-sonnet-thinking","Yes","723","384","143430","178","144715","0.01"
"2025-09-21T19:03:53.523Z","Included","claude-4-sonnet-thinking","Yes","981","0","142449","139","143569","0.01"
"2025-09-21T19:03:46.950Z","Included","claude-4-sonnet-thinking","Yes","528","0","141921","532","142981","0.01"
"2025-09-21T19:03:32.154Z","Included","claude-4-sonnet-thinking","Yes","5293","386","136628","308","142615","0.02"
"2025-09-21T19:03:23.095Z","Included","claude-4-sonnet-thinking","Yes","317","392","136311","169","137189","0.01"
"2025-09-21T19:03:13.386Z","Included","claude-4-sonnet-thinking","Yes","318","389","135993","191","136891","0.01"
"2025-09-21T19:02:59.939Z","Included","claude-4-sonnet-thinking","Yes","716","383","135277","180","136556","0.01"
"2025-09-21T19:02:51.656Z","Included","claude-4-sonnet-thinking","Yes","729","0","134548","137","135414","0.01"
"2025-09-21T19:02:37.856Z","Included","claude-4-sonnet-thinking","Yes","5551","380","128997","401","135329","0.02"
"2025-09-21T19:02:32.006Z","Included","claude-4-sonnet-thinking","Yes","518","0","128479","134","129131","0.01"
"2025-09-21T19:02:26.193Z","Included","claude-4-sonnet-thinking","Yes","348","0","128131","259","128738","0.01"
"2025-09-21T19:02:20.148Z","Included","claude-4-sonnet-thinking","Yes","371","0","127760","166","128297","0.01"
"2025-09-21T19:02:12.900Z","Included","claude-4-sonnet-thinking","Yes","617","0","127143","167","127927","0.01"
"2025-09-21T19:02:07.136Z","Included","claude-4-sonnet-thinking","Yes","618","0","126525","289","127432","0.01"
"2025-09-21T19:02:01.209Z","Included","claude-4-sonnet-thinking","Yes","284","0","126241","171","126696","0.01"
"2025-09-21T19:01:47.377Z","Included","claude-4-sonnet-thinking","Yes","5264","382","120977","178","126801","0.01"
"2025-09-21T19:01:34.251Z","Included","claude-4-sonnet-thinking","Yes","712","381","120265","157","121515","0.01"
"2025-09-21T19:01:24.279Z","Included","claude-4-sonnet-thinking","Yes","847","0","119418","135","120400","0.01"
"2025-09-21T19:01:09.154Z","Included","claude-4-sonnet-thinking","Yes","5293","382","114125","506","120306","0.01"
"2025-09-21T19:01:00.394Z","Included","claude-4-sonnet-thinking","Yes","346","388","113779","162","114675","0.01"
"2025-09-21T19:00:35.458Z","Included","claude-4-sonnet-thinking","Yes","615","388","113164","190","114357","0.01"
"2025-09-21T19:00:26.212Z","Included","claude-4-sonnet-thinking","Yes","503","402","112661","166","113732","0.01"
"2025-09-21T19:00:21.654Z","Included","claude-4-sonnet-thinking","Yes","383","0","112278","176","112837","0.01"
"2025-09-21T19:00:08.762Z","Included","claude-4-sonnet-thinking","Yes","718","382","111560","150","112810","0.01"
"2025-09-21T19:00:02.985Z","Included","claude-4-sonnet-thinking","Yes","387","0","111173","140","111700","0.01"
"2025-09-21T18:59:56.121Z","Errored, Not Charged","claude-4-sonnet-thinking","Yes","562","0","110611","261","111434","0.01"
"2025-09-21T18:59:50.444Z","Included","claude-4-sonnet-thinking","Yes","385","1","110226","297","110909","0.01"
"2025-09-21T18:59:45.304Z","Included","claude-4-sonnet-thinking","Yes","287","1","109939","146","110373","0.01"
"2025-09-21T18:59:38.221Z","Included","claude-4-sonnet-thinking","Yes","388","2","109551","199","110140","0.01"
"2025-09-21T18:59:24.465Z","Included","claude-4-sonnet-thinking","Yes","752","391","108799","153","110095","0.01"
"2025-09-21T18:59:19.713Z","Included","claude-4-sonnet-thinking","Yes","390","3","108409","146","108948","0.01"
"2025-09-21T18:59:11.255Z","Included","claude-4-sonnet-thinking","Yes","784","3","107625","127","108539","0.01"
"2025-09-21T18:58:47.125Z","Included","claude-4-sonnet-thinking","Yes","3129","3","104496","419","108047","0.01"
"2025-09-21T18:58:39.738Z","Included","claude-4-sonnet-thinking","Yes","651","4","103845","1798","106298","0.01"
"2025-09-21T18:58:26.774Z","Included","claude-4-sonnet-thinking","Yes","482","4","103363","433","104282","0.01"
"2025-09-21T18:58:21.165Z","Included","claude-4-sonnet-thinking","Yes","684","5","102679","217","103585","0.01"
"2025-09-21T18:58:10.627Z","Included","claude-4-sonnet-thinking","Yes","471","5","102208","408","103092","0.01"
"2025-09-21T18:58:01.198Z","Included","claude-4-sonnet-thinking","Yes","788","5","101420","210","102423","0.01"
"2025-09-21T18:57:55.967Z","Included","claude-4-sonnet-thinking","Yes","567","6","100853","349","101775","0.01"
"2025-09-21T18:57:48.802Z","Included","claude-4-sonnet-thinking","Yes","559","6","100294","190","101049","0.01"
"2025-09-21T18:57:42.625Z","Included","claude-4-sonnet-thinking","Yes","381","6","99913","258","100558","0.01"
"2025-09-21T18:57:29.571Z","Included","claude-4-sonnet-thinking","Yes","722","384","99191","146","100443","0.01"
"2025-09-21T18:57:24.098Z","Included","claude-4-sonnet-thinking","Yes","378","7","98813","141","99339","0.01"
"2025-09-21T18:57:16.051Z","Included","claude-4-sonnet-thinking","Yes","823","7","97990","115","98935","0.01"
"2025-09-21T18:57:06.617Z","Errored, Not Charged","claude-4-sonnet-thinking","Yes","788","7","97202","440","98437","0.01"
"2025-09-21T18:56:59.436Z","Included","claude-4-sonnet-thinking","Yes","488","7","96714","492","97701","0.01"
"2025-09-21T18:56:54.251Z","Included","claude-4-sonnet-thinking","Yes","355","8","96359","246","96968","0.01"
"2025-09-21T18:56:49.319Z","Included","claude-4-sonnet-thinking","Yes","307","8","96052","167","96534","0.01"
"2025-09-21T18:56:41.808Z","Included","claude-4-sonnet-thinking","Yes","719","8","95333","135","96195","0.01"
"2025-09-21T18:56:34.140Z","Included","claude-4-sonnet-thinking","Yes","680","8","94653","382","95723","0.01"
"2025-09-21T18:56:28.821Z","Included","claude-4-sonnet-thinking","Yes","312","8","94341","386","95047","0.01"
"2025-09-21T18:56:23.828Z","Included","claude-4-sonnet-thinking","Yes","184","8","94157","127","94476","0.01"
"2025-09-21T18:56:18.590Z","Included","claude-4-sonnet-thinking","Yes","448","9","93709","112","94278","0.01"
"2025-09-21T18:56:12.925Z","Included","claude-4-sonnet-thinking","Yes","389","9","93320","188","93906","0.01"
"2025-09-21T18:56:07.137Z","Included","claude-4-sonnet-thinking","Yes","596","9","92724","144","93473","0.01"
"2025-09-21T18:55:55.639Z","Included","claude-4-sonnet-thinking","Yes","1012","9","91712","333","93066","0.01"
"2025-09-21T18:55:44.875Z","Included","claude-4-sonnet-thinking","Yes","1262","9","90450","665","92386","0.01"
"2025-09-21T18:55:37.048Z","Included","claude-4-sonnet-thinking","Yes","426","9","90024","713","91172","0.01"
"2025-09-21T18:55:28.383Z","Included","claude-4-sonnet-thinking","Yes","518","9","89506","178","90211","0.01"
"2025-09-21T18:55:20.114Z","Included","claude-4-sonnet-thinking","Yes","794","9","88712","318","89833","0.01"
"2025-09-21T18:55:13.614Z","Included","claude-4-sonnet-thinking","Yes","399","9","88313","446","89167","0.01"
"2025-09-21T18:55:08.047Z","Included","claude-4-sonnet-thinking","Yes","583","9","87730","192","88514","0.01"
"2025-09-21T18:55:01.316Z","Errored, Not Charged","claude-4-sonnet-thinking","Yes","413","9","87317","135","87874","0.01"
"2025-09-21T18:54:53.611Z","Included","claude-4-sonnet-thinking","Yes","676","9","86641","277","87603","0.01"
"2025-09-21T18:54:37.613Z","Included","claude-4-sonnet-thinking","Yes","13941","391","72700","637","87669","0.02"
"2025-09-21T18:54:06.698Z","Included","claude-4-sonnet-thinking","Yes","62189","303730","10511","5854","382284","0.07"
"2025-09-21T18:52:47.872Z","Included","claude-4-sonnet-thinking","Yes","480","390","547399","1212","549481","0.04"
"2025-09-21T18:51:44.753Z","Included","claude-4-sonnet-thinking","Yes","305","381","547094","177","547957","0.04"
"2025-09-21T18:51:23.219Z","Included","claude-4-sonnet-thinking","Yes","231","362","546863","159","547615","0.04"
"2025-09-21T18:51:12.294Z","Included","claude-4-sonnet-thinking","Yes","449","0","546414","126","546989","0.04"
"2025-09-21T18:50:44.798Z","Included","claude-4-sonnet-thinking","Yes","517","370","545897","232","547016","0.04"
"2025-09-21T18:50:30.711Z","Included","claude-4-sonnet-thinking","Yes","1864","361","544033","141","546399","0.04"
"2025-09-21T18:50:13.945Z","Included","claude-4-sonnet-thinking","Yes","333","376","543700","126","544535","0.04"
"2025-09-21T18:49:59.712Z","Included","claude-4-sonnet-thinking","Yes","556","392","543144","152","544244","0.04"
"2025-09-21T18:48:54.920Z","Included","claude-4-sonnet-thinking","Yes","385","388","542759","189","543721","0.04"
"2025-09-21T18:47:49.430Z","Included","claude-4-sonnet-thinking","Yes","348","383","542411","203","543345","0.04"
"2025-09-21T18:47:34.319Z","Included","claude-4-sonnet-thinking","Yes","321","388","542090","202","543001","0.04"
"2025-09-21T18:47:15.170Z","Included","claude-4-sonnet-thinking","Yes","739","385","541351","183","542658","0.04"
"2025-09-21T18:47:02.502Z","Included","claude-4-sonnet-thinking","Yes","736","0","540615","150","541501","0.04"
"2025-09-21T18:46:52.357Z","Included","claude-4-sonnet-thinking","Yes","421","0","540194","385","541000","0.04"
"2025-09-21T18:46:40.981Z","Included","claude-4-sonnet-thinking","Yes","339","0","539855","142","540336","0.04"
"2025-09-21T18:46:29.936Z","Included","claude-4-sonnet-thinking","Yes","462","0","539393","149","540004","0.04"
"2025-09-21T18:46:10.661Z","Included","claude-4-sonnet-thinking","Yes","5252","385","534141","275","540053","0.04"
"2025-09-21T18:45:56.658Z","Included","claude-4-sonnet-thinking","Yes","508","397","533633","169","534707","0.04"
"2025-09-21T18:45:37.944Z","Included","claude-4-sonnet-thinking","Yes","782","393","532851","193","534219","0.04"
"2025-09-21T18:45:26.210Z","Included","claude-4-sonnet-thinking","Yes","568","1","532283","152","533004","0.04"
"2025-09-21T18:45:13.714Z","Included","claude-4-sonnet-thinking","Yes","649","1","531634","317","532601","0.04"
"2025-09-21T18:45:03.286Z","Included","claude-4-sonnet-thinking","Yes","452","1","531182","358","531993","0.04"
"2025-09-21T18:44:51.499Z","Errored, Not Charged","claude-4-sonnet-thinking","Yes","401","1","530781","137","531320","0.04"
"2025-09-21T18:44:38.379Z","Included","claude-4-sonnet-thinking","Yes","800","1","529981","330","531112","0.04"
"2025-09-21T18:44:27.706Z","Included","claude-4-sonnet-thinking","Yes","451","1","529530","445","530427","0.04"
"2025-09-21T18:44:09.027Z","Included","claude-4-sonnet-thinking","Yes","5210","384","524320","200","530114","0.04"
"2025-09-21T18:43:53.622Z","Included","claude-4-sonnet-thinking","Yes","443","400","523877","170","524890","0.04"
"2025-09-21T18:43:35.767Z","Included","claude-4-sonnet-thinking","Yes","820","387","523057","200","524464","0.04"
"2025-09-21T18:43:23.408Z","Included","claude-4-sonnet-thinking","Yes","500","4","522557","242","523303","0.04"
"2025-09-21T18:43:07.122Z","Included","claude-4-sonnet-thinking","Yes","798","4","521759","323","522884","0.04"
"2025-09-21T18:42:46.590Z","Included","claude-4-sonnet-thinking","Yes","5850","392","515909","439","522590","0.04"
"2025-09-21T18:42:34.718Z","Included","claude-4-sonnet-thinking","Yes","483","6","515426","255","516170","0.04"
"2025-09-21T18:42:31.555Z","Included","claude-4-sonnet-thinking","Yes","487","0","164701","1724","166912","0.02"
"2025-09-21T18:42:24.114Z","Included","claude-4-sonnet-thinking","Yes","576","6","514850","233","515665","0.04"
"2025-09-21T18:42:19.723Z","Included","claude-4-sonnet-thinking","Yes","1095","544","163606","289","165534","0.01"
"2025-09-21T18:42:13.276Z","Included","claude-4-sonnet-thinking","Yes","434","0","163172","308","163914","0.01"
"2025-09-21T18:42:09.337Z","Included","claude-4-sonnet-thinking","Yes","550","6","514300","330","515186","0.04"
"2025-09-21T18:42:06.405Z","Included","claude-4-sonnet-thinking","Yes","393","0","162779","223","163395","0.01"
"2025-09-21T18:41:59.489Z","Included","claude-4-sonnet-thinking","Yes","682","0","162097","137","162916","0.01"
"2025-09-21T18:41:57.663Z","Included","claude-4-sonnet-thinking","Yes","537","6","513763","300","514606","0.04"
"2025-09-21T18:41:52.847Z","Included","claude-4-sonnet-thinking","Yes","309","0","161788","401","162498","0.01"
"2025-09-21T18:41:47.362Z","Included","claude-4-sonnet-thinking","Yes","343","1","161445","147","161936","0.01"
"2025-09-21T18:41:42.941Z","Included","claude-4-sonnet-thinking","Yes","860","6","512903","273","514042","0.04"
"2025-09-21T18:41:38.778Z","Included","claude-4-sonnet-thinking","Yes","274","2","161171","306","161753","0.01"
"2025-09-21T18:41:33.640Z","Errored, Not Charged","claude-4-sonnet-thinking","Yes","211","3","160960","145","161319","0.01"
"2025-09-21T18:41:28.067Z","Errored, Not Charged","claude-4-sonnet-thinking","Yes","221","4","160739","138","161102","0.01"
"2025-09-21T18:41:22.623Z","Included","claude-4-sonnet-thinking","Yes","232","5","160507","146","160890","0.01"
"2025-09-21T18:41:20.449Z","Included","claude-4-sonnet-thinking","Yes","9865","395","503038","469","513767","0.05"
"2025-09-21T18:41:15.779Z","Included","claude-4-sonnet-thinking","Yes","803","6","159704","155","160668","0.01"
"2025-09-21T18:41:09.285Z","Included","claude-4-sonnet-thinking","Yes","455","7","502583","203","503248","0.04"
"2025-09-21T18:41:08.801Z","Included","claude-4-sonnet-thinking","Yes","371","383","159333","200","160287","0.01"
"2025-09-21T18:40:59.559Z","Included","claude-4-sonnet-thinking","Yes","427","398","158906","182","159913","0.01"
"2025-09-21T18:40:58.054Z","Included","claude-4-sonnet-thinking","Yes","508","7","502075","223","502813","0.04"
"2025-09-21T18:40:54.094Z","Included","claude-4-sonnet-thinking","Yes","354","9","158552","164","159079","0.01"
"2025-09-21T18:40:48.374Z","Included","claude-4-sonnet-thinking","Yes","352","9","158200","149","158710","0.01"
"2025-09-21T18:40:46.632Z","Errored, Not Charged","claude-4-sonnet-thinking","Yes","389","7","501686","266","502348","0.04"
"2025-09-21T18:40:43.238Z","Included","claude-4-sonnet-thinking","Yes","351","9","157849","148","158357","0.01"
"2025-09-21T18:40:37.707Z","Included","claude-4-sonnet-thinking","Yes","398","9","157451","148","158006","0.01"
"2025-09-21T18:40:34.663Z","Included","claude-4-sonnet-thinking","Yes","1289","8","500397","303","501997","0.04"
"2025-09-21T18:40:32.285Z","Included","claude-4-sonnet-thinking","Yes","418","9","157033","174","157634","0.01"
"2025-09-21T18:40:24.733Z","Included","claude-4-sonnet-thinking","Yes","596","9","156437","185","157227","0.01"
"2025-09-21T18:40:22.727Z","Included","claude-4-sonnet-thinking","Yes","535","8","499862","167","500572","0.04"
"2025-09-21T18:40:14.409Z","Included","claude-4-sonnet-thinking","Yes","421","411","156016","395","157243","0.01"
"2025-09-21T18:40:11.105Z","Included","claude-4-sonnet-thinking","Yes","705","8","499157","271","500141","0.04"
"2025-09-21T18:40:08.272Z","Included","claude-4-sonnet-thinking","Yes","434","10","155582","184","156210","0.01"
"2025-09-21T18:40:02.169Z","Included","claude-4-sonnet-thinking","Yes","575","10","155007","222","155814","0.01"
"2025-09-21T18:40:00.077Z","Included","claude-4-sonnet-thinking","Yes","502","9","498655","403","499569","0.04"
"2025-09-21T18:39:54.736Z","Included","claude-4-sonnet-thinking","Yes","654","11","154353","257","155275","0.01"
"2025-09-21T18:39:47.123Z","Included","claude-4-sonnet-thinking","Yes","992","9","497663","246","498910","0.04"
"2025-09-21T18:39:46.003Z","Included","claude-4-sonnet-thinking","Yes","578","11","153775","444","154808","0.01"
"2025-09-21T18:39:39.186Z","Included","claude-4-sonnet-thinking","Yes","540","11","153235","220","154006","0.01"
"2025-09-21T18:39:37.568Z","Included","claude-4-sonnet-thinking","Yes","689","9","496974","147","497819","0.04"
"2025-09-21T18:39:30.397Z","Included","claude-4-sonnet-thinking","Yes","3505","11","149730","107","153353","0.01"
"2025-09-21T18:39:27.909Z","Included","claude-4-sonnet-thinking","Yes","486","9","496488","206","497189","0.04"
"2025-09-21T18:39:19.015Z","Included","claude-4-sonnet-thinking","Yes","139219","2982","10511","477","153189","0.13"
"2025-09-21T18:39:17.749Z","Included","claude-4-sonnet-thinking","Yes","545","9","495943","155","496652","0.04"
"2025-09-21T18:39:07.738Z","Included","claude-4-sonnet-thinking","Yes","618","10","495325","255","496208","0.04"
"2025-09-21T18:38:56.794Z","Included","claude-4-sonnet-thinking","Yes","690","10","494635","225","495560","0.04"
"2025-09-21T18:38:42.403Z","Included","claude-4-sonnet-thinking","Yes","5187","408","489448","204","495247","0.04"
"2025-09-21T18:38:24.386Z","Included","claude-4-sonnet-thinking","Yes","478937","4134","10511","304","493886","0.44"
"2025-09-21T18:24:27.765Z","Included","claude-4-sonnet-thinking","Yes","490","392","489248","1391","491521","0.04"
"2025-09-21T18:24:02.277Z","Included","claude-4-sonnet-thinking","Yes","316","371","488932","187","489806","0.04"
"2025-09-21T18:23:50.108Z","Included","claude-4-sonnet-thinking","Yes","1875","363","487057","142","489437","0.04"
"2025-09-21T18:23:41.339Z","Included","claude-4-sonnet-thinking","Yes","293","0","486764","127","487184","0.04"
"2025-09-21T18:23:26.208Z","Included","claude-4-sonnet-thinking","Yes","504","380","486260","141","487285","0.04"
"2025-09-21T18:22:22.662Z","Included","claude-4-sonnet-thinking","Yes","427","388","485833","253","486901","0.04"
"2025-09-21T18:22:07.142Z","Included","claude-4-sonnet-thinking","Yes","13714","387","472119","274","486494","0.05"
"2025-09-21T18:21:50.449Z","Included","claude-4-sonnet-thinking","Yes","778","398","471341","183","472700","0.04"
"2025-09-21T18:21:37.266Z","Included","claude-4-sonnet-thinking","Yes","963","4","470378","164","471509","0.04"
"2025-09-21T18:21:27.675Z","Included","claude-4-sonnet-thinking","Yes","560","5","469818","524","470907","0.04"
"2025-09-21T18:21:16.186Z","Included","claude-4-sonnet-thinking","Yes","610","5","469208","251","470074","0.04"
"2025-09-21T18:20:59.872Z","Included","claude-4-sonnet-thinking","Yes","1591","6","467617","319","469533","0.04"
"2025-09-21T18:20:44.696Z","Included","claude-4-sonnet-thinking","Yes","11410","390","456207","904","468911","0.05"
"2025-09-21T18:20:28.467Z","Included","claude-4-sonnet-thinking","Yes","743","395","455464","184","456786","0.03"
"2025-09-21T18:20:06.180Z","Included","claude-4-sonnet-thinking","Yes","2907","9","452557","159","455632","0.04"
"2025-09-21T18:19:57.930Z","Included","claude-4-sonnet-thinking","Yes","243","9","452314","1275","453841","0.04"
"2025-09-21T18:19:48.660Z","Included","claude-4-sonnet-thinking","Yes","390","9","451924","142","452465","0.03"
"2025-09-21T18:19:38.845Z","Included","claude-4-sonnet-thinking","Yes","491","9","451433","187","452120","0.03"
"2025-09-21T18:19:28.975Z","Included","claude-4-sonnet-thinking","Yes","1539","9","449894","190","451632","0.03"
"2025-09-21T18:19:19.199Z","Included","claude-4-sonnet-thinking","Yes","1646","9","448248","158","450061","0.03"
"2025-09-21T18:19:02.204Z","Included","claude-4-sonnet-thinking","Yes","4897","393","443351","206","448847","0.04"
"2025-09-21T18:18:52.257Z","Included","claude-4-sonnet-thinking","Yes","1634","10","441717","169","443530","0.03"
"2025-09-21T18:18:43.713Z","Included","claude-4-sonnet-thinking","Yes","1555","10","440162","134","441861","0.03"
"2025-09-21T18:18:35.825Z","Included","claude-4-sonnet-thinking","Yes","843","10","439319","144","440316","0.03"
"2025-09-21T18:17:29.561Z","Included","claude-4-sonnet-thinking","Yes","308","402","439011","239","439960","0.03"
"2025-09-21T18:16:26.305Z","Included","claude-4-sonnet-thinking","Yes","5084","412","433927","191","439614","0.04"
"2025-09-21T18:16:02.535Z","Included","claude-4-sonnet-thinking","Yes","423416","4343","10511","334","438604","0.39"
"2025-09-21T18:09:17.635Z","Included","claude-4-sonnet-thinking","Yes","234","362","435712","1389","437697","0.04"
"2025-09-21T18:09:07.445Z","Included","claude-4-sonnet-thinking","Yes","359","0","435353","127","435839","0.03"
"2025-09-21T18:08:57.803Z","Included","claude-4-sonnet-thinking","Yes","486","0","434867","160","435513","0.03"
"2025-09-21T18:08:48.734Z","Included","claude-4-sonnet-thinking","Yes","392","0","434475","254","435121","0.03"
"2025-09-21T18:08:22.752Z","Included","claude-4-sonnet-thinking","Yes","456","380","434019","200","435055","0.03"
"2025-09-21T18:07:20.016Z","Included","claude-4-sonnet-thinking","Yes","420","386","433599","154","434559","0.03"
"2025-09-21T18:07:08.286Z","Included","claude-4-sonnet-thinking","Yes","1873","361","431726","172","434132","0.03"
"2025-09-21T18:06:57.444Z","Included","claude-4-sonnet-thinking","Yes","751","0","430975","131","431857","0.03"
"2025-09-21T18:06:45.650Z","Included","claude-4-sonnet-thinking","Yes","940","0","430035","333","431308","0.03"
"2025-09-21T18:06:37.470Z","Included","claude-4-sonnet-thinking","Yes","877","0","429158","457","430492","0.03"
"2025-09-21T18:06:27.429Z","Included","claude-4-sonnet-thinking","Yes","599","0","428559","144","429302","0.03"
"2025-09-21T18:06:19.191Z","Included","claude-4-sonnet-thinking","Yes","521","0","428038","316","428875","0.03"
"2025-09-21T18:06:07.710Z","Included","claude-4-sonnet-thinking","Yes","860","0","427178","148","428186","0.03"
"2025-09-21T18:05:56.740Z","Included","claude-4-sonnet-thinking","Yes","629","0","426549","442","427620","0.03"
"2025-09-21T18:05:43.832Z","Errored, Not Charged","claude-4-sonnet-thinking","Yes","602","0","425947","350","426899","0.03"
"2025-09-21T18:05:33.056Z","Included","claude-4-sonnet-thinking","Yes","838","0","425109","538","426485","0.03"
"2025-09-21T18:05:11.976Z","Included","claude-4-sonnet-thinking","Yes","10194","386","414915","539","426034","0.04"
"2025-09-21T18:04:53.989Z","Included","claude-4-sonnet-thinking","Yes","1737","0","413178","167","415082","0.03"
"2025-09-21T18:04:34.970Z","Included","claude-4-sonnet-thinking","Yes","10275","398","402903","1039","414615","0.04"
"2025-09-21T18:04:25.070Z","Included","claude-4-sonnet-thinking","Yes","567","2","402336","171","403076","0.03"
"2025-09-21T18:04:14.752Z","Included","claude-4-sonnet-thinking","Yes","746","2","401590","296","402634","0.03"
"2025-09-21T18:04:04.449Z","Included","claude-4-sonnet-thinking","Yes","576","2","401014","386","401978","0.03"
"2025-09-21T18:03:54.919Z","Included","claude-4-sonnet-thinking","Yes","510","2","400504","316","401332","0.03"
"2025-09-21T18:03:46.186Z","Included","claude-4-sonnet-thinking","Yes","426","2","400078","266","400772","0.03"
"2025-09-21T18:03:29.729Z","Included","claude-4-sonnet-thinking","Yes","1700","2","398378","215","400295","0.03"
"2025-09-21T18:03:20.289Z","Included","claude-4-sonnet-thinking","Yes","566","3","397812","967","399348","0.03"
"2025-09-21T18:03:09.567Z","Included","claude-4-sonnet-thinking","Yes","855","3","396957","296","398111","0.03"
"2025-09-21T18:02:50.362Z","Included","claude-4-sonnet-thinking","Yes","10302","399","386655","483","397839","0.04"
"2025-09-21T18:02:29.890Z","Included","claude-4-sonnet-thinking","Yes","2949","5","383706","175","386835","0.03"
"2025-09-21T18:02:22.579Z","Included","claude-4-sonnet-thinking","Yes","459","5","383247","1339","385050","0.03"
"2025-09-21T18:01:58.882Z","Errored, Not Charged","claude-4-sonnet-thinking","Yes","1762","5","381485","150","383402","0.03"
"2025-09-21T18:01:51.702Z","Included","claude-4-sonnet-thinking","Yes","995","6","380490","1538","383029","0.03"
"2025-09-21T18:01:39.170Z","Included","claude-4-sonnet-thinking","Yes","1231","6","379259","140","380636","0.03"
"2025-09-21T18:01:31.651Z","Included","claude-4-sonnet-thinking","Yes","868","7","378391","573","379839","0.03"
"2025-09-21T18:01:06.093Z","Errored, Not Charged","claude-4-sonnet-thinking","Yes","2009","7","376382","144","378542","0.03"
"2025-09-21T18:00:51.589Z","Included","claude-4-sonnet-thinking","Yes","1420","7","374962","1938","378327","0.04"
"2025-09-21T18:00:43.582Z","Included","claude-4-sonnet-thinking","Yes","1478","7","373484","735","375704","0.03"
"2025-09-21T18:00:35.258Z","Included","claude-4-sonnet-thinking","Yes","1377","7","372107","146","373637","0.03"
"2025-09-21T18:00:19.206Z","Included","claude-4-sonnet-thinking","Yes","1846","7","370261","147","372261","0.03"
"2025-09-21T18:00:11.758Z","Included","claude-4-sonnet-thinking","Yes","863","7","369398","831","371099","0.03"
"2025-09-21T17:59:59.728Z","Included","claude-4-sonnet-thinking","Yes","1030","7","368368","144","369549","0.03"
"2025-09-21T17:59:49.289Z","Included","claude-4-sonnet-thinking","Yes","861","8","367507","494","368870","0.03"
"2025-09-21T17:59:41.510Z","Included","claude-4-sonnet-thinking","Yes","1676","8","365831","453","367968","0.03"
"2025-09-21T17:59:28.638Z","Included","claude-4-sonnet-thinking","Yes","1264","8","364567","152","365991","0.03"
"2025-09-21T17:59:21.047Z","Included","claude-4-sonnet-thinking","Yes","1555","8","363012","731","365306","0.03"
"2025-09-21T17:59:19.994Z","Included","claude-4-sonnet-thinking","Yes","800","586","149720","1182","152288","0.02"
"2025-09-21T17:59:13.423Z","Included","claude-4-sonnet-thinking","Yes","1521","8","361491","143","363163","0.03"
"2025-09-21T17:59:13.037Z","Included","claude-4-sonnet-thinking","Yes","460","4","149260","347","150071","0.01"
"2025-09-21T17:59:06.208Z","Included","claude-4-sonnet-thinking","Yes","1730","4","147530","246","149510","0.01"
"2025-09-21T17:59:01.362Z","Included","claude-4-sonnet-thinking","Yes","960","8","360531","139","361638","0.03"
"2025-09-21T17:58:56.675Z","Included","claude-4-sonnet-thinking","Yes","480","384","147050","271","148185","0.01"
"2025-09-21T17:58:51.882Z","Included","claude-4-sonnet-thinking","Yes","402","6","146648","144","147200","0.01"
"2025-09-21T17:58:46.660Z","Included","claude-4-sonnet-thinking","Yes","401","6","146247","159","146813","0.01"
"2025-09-21T17:58:45.990Z","Included","claude-4-sonnet-thinking","Yes","1874","8","358657","536","361075","0.03"
"2025-09-21T17:58:41.378Z","Included","claude-4-sonnet-thinking","Yes","401","6","145846","158","146411","0.01"
"2025-09-21T17:58:38.383Z","Included","claude-4-sonnet-thinking","Yes","1554","9","357103","839","359505","0.03"
"2025-09-21T17:58:36.371Z","Included","claude-4-sonnet-thinking","Yes","383","6","145463","158","146010","0.01"
"2025-09-21T17:58:31.120Z","Included","claude-4-sonnet-thinking","Yes","393","6","145070","155","145624","0.01"
"2025-09-21T17:58:25.841Z","Included","claude-4-sonnet-thinking","Yes","499","6","144571","163","145239","0.01"
"2025-09-21T17:58:25.161Z","Included","claude-4-sonnet-thinking","Yes","1315","9","355788","153","357265","0.03"
"2025-09-21T17:58:18.093Z","Included","claude-4-sonnet-thinking","Yes","1449","10","354339","608","356406","0.03"
"2025-09-21T17:58:17.464Z","Included","claude-4-sonnet-thinking","Yes","439","380","144132","280","145231","0.01"
"2025-09-21T17:58:09.530Z","Included","claude-4-sonnet-thinking","Yes","847","10","353492","151","354500","0.03"
"2025-09-21T17:58:07.973Z","Included","claude-4-sonnet-thinking","Yes","291","398","143841","166","144696","0.01"
"2025-09-21T17:58:01.230Z","Included","claude-4-sonnet-thinking","Yes","430","8","143411","161","144010","0.01"
"2025-09-21T17:58:00.967Z","Included","claude-4-sonnet-thinking","Yes","512","10","352980","150","353652","0.03"
"2025-09-21T17:57:55.382Z","Included","claude-4-sonnet-thinking","Yes","323","8","143088","214","143633","0.01"
"2025-09-21T17:57:53.701Z","Included","claude-4-sonnet-thinking","Yes","665","10","352315","271","353261","0.03"
"2025-09-21T17:57:50.066Z","Included","claude-4-sonnet-thinking","Yes","324","8","142764","206","143302","0.01"
"2025-09-21T17:57:43.559Z","Included","claude-4-sonnet-thinking","Yes","333","8","142431","208","142980","0.01"
"2025-09-21T17:57:42.193Z","Included","claude-4-sonnet-thinking","Yes","919","10","351396","149","352474","0.03"
"2025-09-21T17:57:38.321Z","Included","claude-4-sonnet-thinking","Yes","315","8","142116","213","142652","0.01"
"2025-09-21T17:57:32.679Z","Included","claude-4-sonnet-thinking","Yes","334","8","141782","200","142324","0.01"
"2025-09-21T17:57:32.579Z","Included","claude-4-sonnet-thinking","Yes","1497","10","349899","556","351962","0.03"
"2025-09-21T17:57:26.282Z","Included","claude-4-sonnet-thinking","Yes","439","8","141343","227","142017","0.01"
"2025-09-21T17:57:25.690Z","Included","claude-4-sonnet-thinking","Yes","1508","10","348391","152","350061","0.03"
"2025-09-21T17:57:18.858Z","Included","claude-4-sonnet-thinking","Yes","410","8","140933","332","141683","0.01"
"2025-09-21T17:57:17.169Z","Included","claude-4-sonnet-thinking","Yes","553","10","347838","219","348620","0.03"
"2025-09-21T17:57:12.852Z","Included","claude-4-sonnet-thinking","Yes","720","8","140213","124","141065","0.01"
"2025-09-21T17:57:07.912Z","Included","claude-4-sonnet-thinking","Yes","867","10","346971","195","348043","0.03"
"2025-09-21T17:57:04.066Z","Included","claude-4-sonnet-thinking","Yes","566","8","139647","132","140353","0.01"
"2025-09-21T17:56:59.063Z","Included","claude-4-sonnet-thinking","Yes","877","10","346094","155","347136","0.03"
"2025-09-21T17:56:56.702Z","Included","claude-4-sonnet-thinking","Yes","373","8","139274","350","140005","0.01"
"2025-09-21T17:56:51.695Z","Included","claude-4-sonnet-thinking","Yes","947","10","345147","156","346260","0.03"
"2025-09-21T17:56:49.188Z","Included","claude-4-sonnet-thinking","Yes","316","9","138958","234","139517","0.01"
"2025-09-21T17:56:42.695Z","Included","claude-4-sonnet-thinking","Yes","216","9","138742","154","139121","0.01"
"2025-09-21T17:55:30.397Z","Included","claude-4-sonnet-thinking","Yes","773","10","137969","179","138931","0.01"
"2025-09-21T17:55:22.202Z","Included","claude-4-sonnet-thinking","Yes","4026","11","133943","163","138143","0.01"
"2025-09-21T17:55:10.954Z","Included","claude-4-sonnet-thinking","Yes","123432","3469","10511","511","137923","0.12"
"2025-09-21T17:54:05.315Z","Included","claude-4-sonnet-thinking","Yes","15547","419","329600","395","345961","0.04"
"2025-09-21T17:53:48.789Z","Included","claude-4-sonnet-thinking","Yes","319089","4120","10511","266","333986","0.29"
"2025-09-21T14:00:25.334Z","Included","claude-4-sonnet-thinking","Yes","346","366","329205","872","330789","0.03"
"2025-09-21T14:00:15.196Z","Included","claude-4-sonnet-thinking","Yes","362","375","328843","148","329728","0.02"
"2025-09-21T13:59:58.948Z","Included","claude-4-sonnet-thinking","Yes","1483","391","327360","160","329394","0.03"
"2025-09-21T13:59:37.679Z","Included","claude-4-sonnet-thinking","Yes","328","377","327032","190","327927","0.02"
"2025-09-21T13:59:27.667Z","Included","claude-4-sonnet-thinking","Yes","674","389","326358","153","327574","0.02"
"2025-09-21T13:59:17.591Z","Included","claude-4-sonnet-thinking","Yes","336","366","326022","204","326928","0.02"
"2025-09-21T13:59:08.538Z","Included","claude-4-sonnet-thinking","Yes","691","3","325331","127","326152","0.02"
"2025-09-21T13:59:00.868Z","Included","claude-4-sonnet-thinking","Yes","485","4","324846","376","325711","0.03"
"2025-09-21T13:59:00.135Z","Included","claude-4-sonnet-thinking","Yes","409","0","134541","1258","136208","0.01"
"2025-09-21T13:58:50.912Z","Included","claude-4-sonnet-thinking","Yes","614","374","324232","186","325406","0.02"
"2025-09-21T13:58:49.236Z","Included","claude-4-sonnet-thinking","Yes","922","614","133619","226","135381","0.01"
"2025-09-21T13:58:41.443Z","Included","claude-4-sonnet-thinking","Yes","536","451","133083","447","134517","0.01"
"2025-09-21T13:58:33.998Z","Included","claude-4-sonnet-thinking","Yes","580","452","132503","251","133786","0.01"
"2025-09-21T13:58:33.633Z","Included","claude-4-sonnet-thinking","Yes","233","368","323999","156","324756","0.02"
"2025-09-21T13:58:23.006Z","Included","claude-4-sonnet-thinking","Yes","244","372","323755","137","324508","0.02"
"2025-09-21T13:58:21.691Z","Included","claude-4-sonnet-thinking","Yes","828","554","131675","401","133458","0.01"
"2025-09-21T13:58:13.556Z","Included","claude-4-sonnet-thinking","Yes","263","372","323492","146","324273","0.02"
"2025-09-21T13:58:12.794Z","Included","claude-4-sonnet-thinking","Yes","635","458","131040","413","132546","0.01"
"2025-09-21T13:58:05.482Z","Included","claude-4-sonnet-thinking","Yes","539","377","130501","268","131685","0.01"
"2025-09-21T13:58:04.154Z","Included","claude-4-sonnet-thinking","Yes","1877","370","321615","140","324002","0.03"
"2025-09-21T13:57:59.190Z","Included","claude-4-sonnet-thinking","Yes","356","390","130145","171","131062","0.01"
"2025-09-21T13:57:57.532Z","Included","claude-4-sonnet-thinking","Yes","452","9","321163","128","321752","0.02"
"2025-09-21T13:57:53.989Z","Included","claude-4-sonnet-thinking","Yes","422","5","129723","158","130308","0.01"
"2025-09-21T13:57:47.404Z","Included","claude-4-sonnet-thinking","Yes","300","371","320863","219","321753","0.02"
"2025-09-21T13:57:45.507Z","Included","claude-4-sonnet-thinking","Yes","337","5","129386","227","129955","0.01"
"2025-09-21T13:57:39.333Z","Included","claude-4-sonnet-thinking","Yes","401","5","128985","187","129578","0.01"
"2025-09-21T13:57:35.025Z","Included","claude-4-sonnet-thinking","Yes","4704","383","316159","144","321390","0.03"
"2025-09-21T13:57:31.076Z","Included","claude-4-sonnet-thinking","Yes","405","6","128580","239","129230","0.01"
"2025-09-21T13:57:24.514Z","Included","claude-4-sonnet-thinking","Yes","367","7","128213","220","128807","0.01"
"2025-09-21T13:57:17.047Z","Included","claude-4-sonnet-thinking","Yes","576","389","127637","246","128848","0.01"
"2025-09-21T13:57:11.005Z","Included","claude-4-sonnet-thinking","Yes","411","8","127226","176","127821","0.01"
"2025-09-21T13:57:03.534Z","Included","claude-4-sonnet-thinking","Yes","564","8","126662","270","127504","0.01"
"2025-09-21T13:57:00.549Z","Included","claude-4-sonnet-thinking","Yes","305648","4305","10511","224","320688","0.28"
"2025-09-21T13:56:56.582Z","Included","claude-4-sonnet-thinking","Yes","738","8","125924","369","127039","0.01"
"2025-09-21T13:56:51.217Z","Included","claude-4-sonnet-thinking","Yes","421","382","125503","112","126418","0.01"
"2025-09-21T13:56:44.338Z","Included","claude-4-sonnet-thinking","Yes","1789","384","123714","160","126047","0.01"
"2025-09-21T13:56:38.123Z","Included","claude-4-sonnet-thinking","Yes","328","10","123386","201","123925","0.01"
"2025-09-21T13:56:32.533Z","Included","claude-4-sonnet-thinking","Yes","269","10","123117","144","123540","0.01"
"2025-09-21T13:56:25.981Z","Included","claude-4-sonnet-thinking","Yes","3409","10","119708","131","123258","0.01"
"2025-09-21T13:56:14.771Z","Included","claude-4-sonnet-thinking","Yes","109197","2909","10511","453","123070","0.10"
"2025-09-21T13:50:12.708Z","Included","claude-4-sonnet-thinking","Yes","314","388","121081","1309","123092","0.01"
"2025-09-21T13:50:05.402Z","Included","claude-4-sonnet-thinking","Yes","569","403","120512","188","121672","0.01"
"2025-09-21T13:49:57.730Z","Included","claude-4-sonnet-thinking","Yes","532","382","119980","186","121080","0.01"
"2025-09-21T13:49:52.748Z","Included","claude-4-sonnet-thinking","Yes","380","0","119600","153","120133","0.01"
"2025-09-21T13:49:44.721Z","Included","claude-4-sonnet-thinking","Yes","523","388","119077","185","120173","0.01"
"2025-09-21T13:49:30.853Z","Included","claude-4-sonnet-thinking","Yes","1487","0","117590","180","119257","0.01"
"2025-09-21T13:49:24.726Z","Included","claude-4-sonnet-thinking","Yes","757","0","116833","996","118586","0.01"
"2025-09-21T13:49:19.508Z","Included","claude-4-sonnet-thinking","Yes","490","388","116343","107","117328","0.01"
"2025-09-21T13:49:07.990Z","Included","claude-4-sonnet-thinking","Yes","764","399","115579","390","117132","0.01"
"2025-09-21T13:48:58.660Z","Included","claude-4-sonnet-thinking","Yes","274","0","115305","296","115875","0.01"
"2025-09-21T13:48:53.861Z","Included","claude-4-sonnet-thinking","Yes","173","1","115132","162","115468","0.01"
"2025-09-21T13:48:50.394Z","Included","claude-4-sonnet-thinking","Yes","220","1","114912","70","115203","0.01"
"2025-09-21T13:48:44.959Z","Included","claude-4-sonnet-thinking","Yes","182","1","114730","129","115042","0.01"
"2025-09-21T13:48:40.127Z","Errored, Not Charged","claude-4-sonnet-thinking","Yes","228","1","114502","102","114833","0.01"
"2025-09-21T13:48:33.675Z","Included","claude-4-sonnet-thinking","Yes","495","2","114007","153","114657","0.01"
"2025-09-21T13:48:27.792Z","Included","claude-4-sonnet-thinking","Yes","165","2","113842","134","114143","0.01"
"2025-09-21T13:48:24.172Z","Included","claude-4-sonnet-thinking","Yes","139","3","113703","97","113942","0.01"
"2025-09-21T13:48:19.949Z","Included","claude-4-sonnet-thinking","Yes","214","4","113489","102","113809","0.01"
"2025-09-21T13:48:11.729Z","Errored, Not Charged","claude-4-sonnet-thinking","Yes","396","5","113093","177","113671","0.01"
"2025-09-21T13:48:02.713Z","Included","claude-4-sonnet-thinking","Yes","770","399","112323","341","113833","0.01"
"2025-09-21T13:47:58.332Z","Included","claude-4-sonnet-thinking","Yes","423","7","111900","161","112491","0.01"
"2025-09-21T13:47:52.220Z","Included","claude-4-sonnet-thinking","Yes","1142","7","110758","216","112123","0.01"
"2025-09-21T13:47:42.629Z","Included","claude-4-sonnet-thinking","Yes","415","7","110343","306","111071","0.01"
"2025-09-21T13:47:35.407Z","Included","claude-4-sonnet-thinking","Yes","343","8","110000","228","110579","0.01"
"2025-09-21T13:47:27.279Z","Included","claude-4-sonnet-thinking","Yes","466","8","109534","185","110193","0.01"
"2025-09-21T13:47:20.268Z","Included","claude-4-sonnet-thinking","Yes","429","8","109105","133","109675","0.01"
"2025-09-21T13:47:14.031Z","Included","claude-4-sonnet-thinking","Yes","538","8","108567","107","109220","0.01"
"2025-09-21T13:47:08.038Z","Included","claude-4-sonnet-thinking","Yes","368","8","108199","240","108815","0.01"
"2025-09-21T13:47:00.762Z","Included","claude-4-sonnet-thinking","Yes","594","9","107605","182","108390","0.01"
"2025-09-21T13:46:53.855Z","Included","claude-4-sonnet-thinking","Yes","445","9","107160","387","108001","0.01"
"2025-09-21T13:46:47.970Z","Included","claude-4-sonnet-thinking","Yes","520","10","106640","163","107333","0.01"
"2025-09-21T13:46:42.837Z","Included","claude-4-sonnet-thinking","Yes","1560","11","105080","209","106860","0.01"
"2025-09-21T13:46:36.810Z","Included","claude-4-sonnet-thinking","Yes","965","11","104115","192","105283","0.01"
"2025-09-21T13:46:31.590Z","Included","claude-4-sonnet-thinking","Yes","431","11","103684","95","104221","0.01"
"2025-09-21T13:46:24.361Z","Included","claude-4-sonnet-thinking","Yes","363","11","103321","196","103891","0.01"
"2025-09-21T13:46:17.298Z","Included","claude-4-sonnet-thinking","Yes","2812","11","100509","115","103447","0.01"
"2025-09-21T13:46:08.112Z","Included","claude-4-sonnet-thinking","Yes","89998","2330","10511","436","103275","0.09"
"2025-09-21T13:13:00.444Z","Included","claude-4-sonnet-thinking","Yes","167","0","102437","1103","103707","0.01"
"2025-09-21T13:12:55.985Z","Included","claude-4-sonnet-thinking","Yes","243","374","316092","731","317440","0.03"
"2025-09-21T13:12:55.878Z","Included","claude-4-sonnet-thinking","Yes","454","0","101983","131","102568","0.01"
"2025-09-21T13:12:49.987Z","Included","claude-4-sonnet-thinking","Yes","451","0","101532","261","102244","0.01"
"2025-09-21T13:12:44.739Z","Included","claude-4-sonnet-thinking","Yes","143","0","101389","142","101674","0.01"
"2025-09-21T13:12:39.827Z","Included","claude-4-sonnet-thinking","Yes","253","0","101136","107","101496","0.01"
"2025-09-21T13:12:38.083Z","Included","claude-4-sonnet-thinking","Yes","243","368","315849","164","316624","0.02"
"2025-09-21T13:12:33.963Z","Included","claude-4-sonnet-thinking","Yes","356","0","100780","217","101353","0.01"
"2025-09-21T13:12:26.472Z","Included","claude-4-sonnet-thinking","Yes","649","387","315200","147","316383","0.02"
"2025-09-21T13:12:26.141Z","Included","claude-4-sonnet-thinking","Yes","538","404","100242","268","101452","0.01"
"2025-09-21T13:12:16.327Z","Included","claude-4-sonnet-thinking","Yes","1709","2","98533","396","100640","0.01"
"2025-09-21T13:12:09.797Z","Included","claude-4-sonnet-thinking","Yes","397","3","98136","161","98697","0.01"
"2025-09-21T13:12:09.477Z","Included","claude-4-sonnet-thinking","Yes","242","373","314958","173","315746","0.02"
"2025-09-21T13:12:03.241Z","Included","claude-4-sonnet-thinking","Yes","417","3","97719","202","98341","0.01"
"2025-09-21T13:12:01.417Z","Included","claude-4-sonnet-thinking","Yes","573","6","314385","136","315100","0.02"
"2025-09-21T13:11:56.320Z","Included","claude-4-sonnet-thinking","Yes","972","3","96747","192","97914","0.01"
"2025-09-21T13:11:52.548Z","Included","claude-4-sonnet-thinking","Yes","553","6","313832","281","314672","0.02"
"2025-09-21T13:11:48.962Z","Included","claude-4-sonnet-thinking","Yes","364","3","96383","463","97213","0.01"
"2025-09-21T13:11:44.234Z","Included","claude-4-sonnet-thinking","Yes","477","3","95906","159","96545","0.01"
"2025-09-21T13:11:39.311Z","Included","claude-4-sonnet-thinking","Yes","1210","6","312622","149","313987","0.02"
"2025-09-21T13:11:35.745Z","Included","claude-4-sonnet-thinking","Yes","754","3","95152","152","96061","0.01"
"2025-09-21T13:11:30.557Z","Included","claude-4-sonnet-thinking","Yes","724","3","94428","512","95667","0.01"
"2025-09-21T13:11:29.723Z","Included","claude-4-sonnet-thinking","Yes","931","7","311691","649","313278","0.03"
"2025-09-21T13:11:24.818Z","Included","claude-4-sonnet-thinking","Yes","265","3","94163","140","94571","0.01"
"2025-09-21T13:11:21.360Z","Included","claude-4-sonnet-thinking","Yes","790","7","310901","497","312195","0.02"
"2025-09-21T13:11:20.705Z","Included","claude-4-sonnet-thinking","Yes","692","4","93471","156","94323","0.01"
"2025-09-21T13:11:15.542Z","Included","claude-4-sonnet-thinking","Yes","298","4","93173","140","93615","0.01"
"2025-09-21T13:11:12.681Z","Included","claude-4-sonnet-thinking","Yes","732","7","310169","416","311324","0.02"
"2025-09-21T13:11:05.928Z","Included","claude-4-sonnet-thinking","Yes","473","7","309696","385","310561","0.02"
"2025-09-21T13:11:01.657Z","Included","claude-4-sonnet-thinking","Yes","1450","5","91723","156","93334","0.01"
"2025-09-21T13:10:55.513Z","Included","claude-4-sonnet-thinking","Yes","1248","389","308448","192","310277","0.02"
"2025-09-21T13:10:53.023Z","Errored, Not Charged","claude-4-sonnet-thinking","Yes","537","5","91186","907","92635","0.01"
"2025-09-21T13:10:48.301Z","Included","claude-4-sonnet-thinking","Yes","286","6","90900","451","91643","0.01"
"2025-09-21T13:10:41.049Z","Errored, Not Charged","claude-4-sonnet-thinking","Yes","502","6","90398","136","91042","0.01"
"2025-09-21T13:10:36.024Z","Included","claude-4-sonnet-thinking","Yes","234","372","308214","178","308998","0.02"
"2025-09-21T13:10:33.533Z","Errored, Not Charged","claude-4-sonnet-thinking","Yes","110","6","90288","431","90835","0.01"
"2025-09-21T13:10:27.966Z","Included","claude-4-sonnet-thinking","Yes","485","9","307729","128","308351","0.02"
"2025-09-21T13:10:19.418Z","Included","claude-4-sonnet-thinking","Yes","679","10","307050","267","308006","0.02"
"2025-09-21T13:10:14.563Z","Errored, Not Charged","claude-4-sonnet-thinking","Yes","1816","6","88472","501","90795","0.01"
"2025-09-21T13:10:11.128Z","Included","claude-4-sonnet-thinking","Yes","528","10","306522","348","307408","0.02"
"2025-09-21T13:10:09.469Z","Included","claude-4-sonnet-thinking","Yes","849","6","87623","1745","90223","0.01"
"2025-09-21T13:10:02.053Z","Included","claude-4-sonnet-thinking","Yes","752","7","86871","246","87876","0.01"
"2025-09-21T13:09:53.328Z","Included","claude-4-sonnet-thinking","Yes","4514","380","302008","204","307106","0.03"
"2025-09-21T13:09:52.393Z","Errored, Not Charged","claude-4-sonnet-thinking","Yes","600","8","86271","184","87063","0.01"
"2025-09-21T13:09:46.292Z","Included","claude-4-sonnet-thinking","Yes","439","9","85832","514","86794","0.01"
"2025-09-21T13:09:38.700Z","Errored, Not Charged","claude-4-sonnet-thinking","Yes","499","10","85333","170","86012","0.01"
"2025-09-21T13:09:33.738Z","Included","claude-4-sonnet-thinking","Yes","659","11","84674","413","85757","0.01"
"2025-09-21T13:09:28.796Z","Included","claude-4-sonnet-thinking","Yes","291497","4034","10511","188","306230","0.27"
"2025-09-21T13:09:25.978Z","Errored, Not Charged","claude-4-sonnet-thinking","Yes","620","11","84054","149","84834","0.01"
"2025-09-21T13:09:18.756Z","Included","claude-4-sonnet-thinking","Yes","577","11","83477","549","84614","0.01"
"2025-09-21T13:09:13.078Z","Included","claude-4-sonnet-thinking","Yes","576","11","82901","180","83668","0.01"
"2025-09-21T13:09:06.136Z","Included","claude-4-sonnet-thinking","Yes","753","11","82148","381","83293","0.01"
"2025-09-21T13:08:58.800Z","Included","claude-4-sonnet-thinking","Yes","657","11","81491","283","82442","0.01"
"2025-09-21T13:08:52.621Z","Included","claude-4-sonnet-thinking","Yes","1215","11","80276","198","81700","0.01"
"2025-09-21T13:08:46.072Z","Included","claude-4-sonnet-thinking","Yes","2141","11","78135","141","80428","0.01"
"2025-09-21T13:08:38.417Z","Included","claude-4-sonnet-thinking","Yes","67624","1675","10511","420","80230","0.06"
"2025-09-21T13:05:50.897Z","Included","claude-4-sonnet-thinking","Yes","255","366","306039","965","307625","0.03"
"2025-09-21T13:05:41.823Z","Included","claude-4-sonnet-thinking","Yes","1873","364","304166","133","306536","0.02"
"2025-09-21T13:05:32.940Z","Included","claude-4-sonnet-thinking","Yes","514","367","303652","135","304668","0.02"
"2025-09-21T13:03:58.606Z","Included","claude-4-sonnet-thinking","Yes","587","390","303065","359","304401","0.02"
"2025-09-21T13:03:48.443Z","Included","claude-4-sonnet-thinking","Yes","640","381","302425","216","303662","0.02"
"2025-09-21T13:03:39.263Z","Included","claude-4-sonnet-thinking","Yes","616","0","301809","161","302586","0.02"
"2025-09-21T13:03:31.546Z","Included","claude-4-sonnet-thinking","Yes","578","0","301231","370","302179","0.02"
"2025-09-21T13:03:19.367Z","Included","claude-4-sonnet-thinking","Yes","5024","383","296207","344","301958","0.03"
"2025-09-21T13:03:02.661Z","Included","claude-4-sonnet-thinking","Yes","10556","389","285651","319","296915","0.03"
"2025-09-21T13:02:55.836Z","Included","claude-4-sonnet-thinking","Yes","706","0","284945","208","285859","0.02"
"2025-09-21T13:02:43.085Z","Included","claude-4-sonnet-thinking","Yes","1229","0","283716","170","285115","0.02"
"2025-09-21T13:02:35.163Z","Included","claude-4-sonnet-thinking","Yes","579","0","283137","754","284470","0.02"
"2025-09-21T13:02:22.717Z","Included","claude-4-sonnet-thinking","Yes","10717","381","272420","362","283880","0.03"
"2025-09-21T13:02:09.271Z","Included","claude-4-sonnet-thinking","Yes","580","378","271840","177","272975","0.02"
"2025-09-21T13:02:02.042Z","Included","claude-4-sonnet-thinking","Yes","588","0","271252","143","271983","0.02"
"2025-09-21T13:01:47.266Z","Included","claude-4-sonnet-thinking","Yes","4503","385","266749","319","271956","0.02"
"2025-09-21T13:01:40.989Z","Included","claude-4-sonnet-thinking","Yes","452","0","266297","211","266960","0.02"
"2025-09-21T13:01:32.132Z","Included","claude-4-sonnet-thinking","Yes","725","0","265572","171","266468","0.02"
"2025-09-21T13:01:24.225Z","Included","claude-4-sonnet-thinking","Yes","440","0","265132","372","265944","0.02"
"2025-09-21T13:01:18.190Z","Included","claude-4-sonnet-thinking","Yes","718","0","264414","220","265352","0.02"
"2025-09-21T13:01:09.552Z","Errored, Not Charged","claude-4-sonnet-thinking","Yes","484","0","263930","140","264554","0.02"
"2025-09-21T13:01:01.610Z","Included","claude-4-sonnet-thinking","Yes","683","0","263247","413","264343","0.02"
"2025-09-21T13:00:54.291Z","Included","claude-4-sonnet-thinking","Yes","672","0","262575","329","263576","0.02"
"2025-09-21T13:00:42.377Z","Included","claude-4-sonnet-thinking","Yes","11535","378","251040","422","263375","0.03"
"2025-09-21T13:00:28.056Z","Included","claude-4-sonnet-thinking","Yes","586","382","250454","177","251599","0.02"
"2025-09-21T13:00:20.477Z","Included","claude-4-sonnet-thinking","Yes","615","0","249839","151","250605","0.02"
"2025-09-21T13:00:01.109Z","Included","claude-4-sonnet-thinking","Yes","3377","0","246462","291","250130","0.02"
"2025-09-21T12:59:41.715Z","Included","claude-4-sonnet-thinking","Yes","1717","0","244745","1535","247997","0.02"
"2025-09-21T12:59:35.250Z","Included","claude-4-sonnet-thinking","Yes","537","0","244208","1464","246209","0.02"
"2025-09-21T12:59:19.386Z","Included","claude-4-sonnet-thinking","Yes","4234","382","239974","219","244809","0.02"
"2025-09-21T12:59:10.729Z","Included","claude-4-sonnet-thinking","Yes","553","1","239421","145","240120","0.02"
"2025-09-21T12:59:01.372Z","Included","claude-4-sonnet-thinking","Yes","933","1","238488","280","239702","0.02"
"2025-09-21T12:58:46.708Z","Included","claude-4-sonnet-thinking","Yes","4391","382","234097","530","239400","0.02"
"2025-09-21T12:58:30.693Z","Included","claude-4-sonnet-thinking","Yes","1955","2","232142","150","234249","0.02"
"2025-09-21T12:58:24.703Z","Included","claude-4-sonnet-thinking","Yes","941","3","231201","1166","233311","0.02"
"2025-09-21T12:58:18.503Z","Included","claude-4-sonnet-thinking","Yes","564","3","230637","165","231369","0.02"
"2025-09-21T12:58:04.004Z","Included","claude-4-sonnet-thinking","Yes","4389","387","226248","188","231212","0.02"
"2025-09-21T12:57:54.923Z","Included","claude-4-sonnet-thinking","Yes","907","4","225341","148","226400","0.02"
"2025-09-21T12:57:44.067Z","Included","claude-4-sonnet-thinking","Yes","1161","4","224180","498","225843","0.02"
"2025-09-21T12:57:27.505Z","Included","claude-4-sonnet-thinking","Yes","6201","388","217979","706","225274","0.02"
"2025-09-21T12:57:13.344Z","Included","claude-4-sonnet-thinking","Yes","1562","5","216417","175","218159","0.02"
"2025-09-21T12:56:50.682Z","Included","claude-4-sonnet-thinking","Yes","11568","388","204849","916","217721","0.03"
"2025-09-21T12:56:39.387Z","Included","claude-4-sonnet-thinking","Yes","891","6","203958","162","205017","0.02"
"2025-09-21T12:56:34.544Z","Included","claude-4-sonnet-thinking","Yes","607","7","203351","521","204486","0.02"
"2025-09-21T12:56:27.156Z","Included","claude-4-sonnet-thinking","Yes","698","7","202653","133","203491","0.02"
"2025-09-21T12:56:18.670Z","Included","claude-4-sonnet-thinking","Yes","678","8","201975","380","203041","0.02"
"2025-09-21T12:56:09.022Z","Included","claude-4-sonnet-thinking","Yes","843","8","201132","384","202367","0.02"
"2025-09-21T12:55:57.979Z","Included","claude-4-sonnet-thinking","Yes","697","8","200435","483","201623","0.02"
"2025-09-21T12:55:49.646Z","Included","claude-4-sonnet-thinking","Yes","832","8","199603","365","200808","0.02"
"2025-09-21T12:55:42.255Z","Included","claude-4-sonnet-thinking","Yes","498","8","199105","440","200051","0.02"
"2025-09-21T12:55:26.351Z","Included","claude-4-sonnet-thinking","Yes","1602","9","197503","291","199405","0.02"
"2025-09-21T12:55:15.377Z","Included","claude-4-sonnet-thinking","Yes","745","9","196758","892","198404","0.02"
"2025-09-21T12:55:07.797Z","Included","claude-4-sonnet-thinking","Yes","1030","10","195728","424","197192","0.02"
"2025-09-21T12:54:57.919Z","Included","claude-4-sonnet-thinking","Yes","1025","10","194703","322","196060","0.02"
"2025-09-21T12:54:48.430Z","Included","claude-4-sonnet-thinking","Yes","1478","10","193225","243","194956","0.02"
"2025-09-21T12:54:39.832Z","Included","claude-4-sonnet-thinking","Yes","627","10","192598","269","193504","0.02"
"2025-09-21T12:54:32.172Z","Included","claude-4-sonnet-thinking","Yes","2545","10","190053","217","192825","0.02"
"2025-09-21T12:54:24.685Z","Included","claude-4-sonnet-thinking","Yes","1370","10","188683","150","190213","0.02"
"2025-09-21T12:54:16.920Z","Included","claude-4-sonnet-thinking","Yes","1594","10","187089","181","188874","0.02"
"2025-09-21T12:54:11.518Z","Included","claude-4-sonnet-thinking","Yes","1052","10","186037","174","187273","0.01"
"2025-09-21T12:53:40.058Z","Included","claude-4-sonnet-thinking","Yes","11581","391","174456","305","186733","0.02"
"2025-09-21T12:53:20.679Z","Included","claude-4-sonnet-thinking","Yes","1264","409","173192","205","175070","0.01"
"2025-09-21T12:53:05.896Z","Included","claude-4-sonnet-thinking","Yes","4462","411","168730","184","173787","0.02"
"2025-09-21T12:52:54.295Z","Included","claude-4-sonnet-thinking","Yes","158219","3127","10511","321","172178","0.15"
"2025-09-21T12:44:12.591Z","Included","claude-4-sonnet-thinking","Yes","635","0","169221","868","170724","0.02"
"2025-09-21T12:44:04.829Z","Included","claude-4-sonnet-thinking","Yes","757","0","168464","348","169569","0.01"
"2025-09-21T12:43:56.493Z","Included","claude-4-sonnet-thinking","Yes","765","0","167699","384","168848","0.01"
"2025-09-21T12:43:50.632Z","Included","claude-4-sonnet-thinking","Yes","577","0","167122","439","168138","0.01"
"2025-09-21T12:42:17.438Z","Included","claude-4-sonnet-thinking","Yes","10338","382","156784","272","167776","0.02"
"2025-09-21T12:42:12.574Z","Included","claude-4-sonnet-thinking","Yes","331","0","156453","149","156933","0.01"
"2025-09-21T12:42:04.517Z","Included","claude-4-sonnet-thinking","Yes","254","365","156199","142","156960","0.01"
"2025-09-21T12:41:57.022Z","Included","claude-4-sonnet-thinking","Yes","1863","362","154336","132","156693","0.01"
"2025-09-21T12:41:49.182Z","Included","claude-4-sonnet-thinking","Yes","316","365","154020","128","154829","0.01"
"2025-09-21T12:41:34.909Z","Included","claude-4-sonnet-thinking","Yes","1157","387","152863","145","154552","0.01"
"2025-09-21T12:41:28.057Z","Included","claude-4-sonnet-thinking","Yes","593","0","152270","159","153022","0.01"
"2025-09-21T12:41:21.334Z","Included","claude-4-sonnet-thinking","Yes","586","0","151684","306","152576","0.01"
"2025-09-21T12:41:15.083Z","Included","claude-4-sonnet-thinking","Yes","571","0","151113","306","151990","0.01"
"2025-09-21T12:41:05.210Z","Included","claude-4-sonnet-thinking","Yes","816","0","150297","294","151407","0.01"
"2025-09-21T12:40:48.072Z","Included","claude-4-sonnet-thinking","Yes","10770","387","139527","484","151168","0.02"
"2025-09-21T12:40:40.449Z","Included","claude-4-sonnet-thinking","Yes","452","0","139075","160","139687","0.01"
"2025-09-21T12:40:32.362Z","Included","claude-4-sonnet-thinking","Yes","698","0","138377","250","139325","0.01"
"2025-09-21T12:40:20.791Z","Included","claude-4-sonnet-thinking","Yes","1156","0","137221","377","138754","0.01"
"2025-09-21T12:40:13.213Z","Included","claude-4-sonnet-thinking","Yes","745","0","136476","624","137845","0.01"
"2025-09-21T12:40:01.066Z","Included","claude-4-sonnet-thinking","Yes","1013","1","135463","405","136882","0.01"
"2025-09-21T12:39:42.626Z","Included","claude-4-sonnet-thinking","Yes","3125","1","132338","579","136043","0.01"
"2025-09-21T12:39:37.469Z","Included","claude-4-sonnet-thinking","Yes","1464","1","130874","1771","134110","0.02"
"2025-09-21T12:39:27.644Z","Included","claude-4-sonnet-thinking","Yes","928","1","129946","100","130975","0.01"
"2025-09-21T12:39:21.039Z","Included","claude-4-sonnet-thinking","Yes","641","2","129305","478","130426","0.01"
"2025-09-21T12:39:13.463Z","Included","claude-4-sonnet-thinking","Yes","718","3","128587","333","129641","0.01"
"2025-09-21T12:39:07.060Z","Included","claude-4-sonnet-thinking","Yes","685","4","127902","386","128977","0.01"
"2025-09-21T12:39:00.039Z","Included","claude-4-sonnet-thinking","Yes","675","5","127227","353","128260","0.01"
"2025-09-21T12:38:54.841Z","Included","claude-4-sonnet-thinking","Yes","754","6","126473","360","127593","0.01"
"2025-09-21T12:38:44.498Z","Included","claude-4-sonnet-thinking","Yes","1208","6","125265","147","126626","0.01"
"2025-09-21T12:38:31.098Z","Included","claude-4-sonnet-thinking","Yes","1570","6","123695","696","125967","0.01"
"2025-09-21T12:38:22.086Z","Included","claude-4-sonnet-thinking","Yes","962","6","122733","886","124587","0.01"
"2025-09-21T12:38:13.086Z","Included","claude-4-sonnet-thinking","Yes","896","6","121837","502","123241","0.01"
"2025-09-21T12:38:01.242Z","Included","claude-4-sonnet-thinking","Yes","1425","6","120412","479","122322","0.01"
"2025-09-21T12:37:56.006Z","Included","claude-4-sonnet-thinking","Yes","822","6","119590","769","121187","0.01"
"2025-09-21T12:37:46.138Z","Included","claude-4-sonnet-thinking","Yes","1889","370","117701","183","120143","0.01"
"2025-09-21T12:37:41.769Z","Included","claude-4-sonnet-thinking","Yes","340","7","117361","129","117837","0.01"
"2025-09-21T12:37:37.322Z","Included","claude-4-sonnet-thinking","Yes","301","7","117060","137","117505","0.01"
"2025-09-21T12:37:32.591Z","Included","claude-4-sonnet-thinking","Yes","333","7","116727","136","117203","0.01"
"2025-09-21T12:37:28.668Z","Included","claude-4-sonnet-thinking","Yes","333","7","116394","136","116870","0.01"
"2025-09-21T12:37:24.488Z","Included","claude-4-sonnet-thinking","Yes","331","7","116063","136","116537","0.01"
"2025-09-21T12:37:20.628Z","Included","claude-4-sonnet-thinking","Yes","332","7","115731","139","116209","0.01"
"2025-09-21T12:37:16.323Z","Included","claude-4-sonnet-thinking","Yes","359","7","115372","142","115880","0.01"
"2025-09-21T12:37:12.051Z","Included","claude-4-sonnet-thinking","Yes","306","7","115066","148","115527","0.01"
"2025-09-21T12:37:05.255Z","Errored, Not Charged","claude-4-sonnet-thinking","Yes","479","7","114587","117","115190","0.01"
"2025-09-21T12:37:00.919Z","Included","claude-4-sonnet-thinking","Yes","361","7","114226","286","114880","0.01"
"2025-09-21T12:36:57.224Z","Errored, Not Charged","claude-4-sonnet-thinking","Yes","231","8","113995","101","114335","0.01"
"2025-09-21T12:36:49.260Z","Included","claude-4-sonnet-thinking","Yes","370","376","113625","172","114543","0.01"
"2025-09-21T12:35:37.775Z","Included","claude-4-sonnet-thinking","Yes","312","402","79119","1203","81036","0.01"
"2025-09-21T12:35:32.383Z","Included","claude-4-sonnet-thinking","Yes","449","1","78670","170","79290","0.01"
"2025-09-21T12:35:26.130Z","Included","claude-4-sonnet-thinking","Yes","483","1","78187","249","78920","0.01"
"2025-09-21T12:35:22.606Z","Included","claude-4-sonnet-thinking","Yes","4147","401","109478","200","114226","0.01"
"2025-09-21T12:35:21.550Z","Included","claude-4-sonnet-thinking","Yes","224","2","77963","143","78332","0.01"
"2025-09-21T12:35:17.358Z","Included","claude-4-sonnet-thinking","Yes","344","3","77619","187","78153","0.01"
"2025-09-21T12:35:15.998Z","Included","claude-4-sonnet-thinking","Yes","2822","11","106656","187","109676","0.01"
"2025-09-21T12:35:12.124Z","Included","claude-4-sonnet-thinking","Yes","569","3","77050","130","77752","0.01"
"2025-09-21T12:35:08.597Z","Included","claude-4-sonnet-thinking","Yes","96145","2410","10511","366","109432","0.09"
"2025-09-21T12:35:07.725Z","Included","claude-4-sonnet-thinking","Yes","386","3","76664","310","77363","0.01"
"2025-09-21T12:35:01.583Z","Included","claude-4-sonnet-thinking","Yes","472","3","76192","141","76808","0.01"
"2025-09-21T12:34:56.298Z","Included","claude-4-sonnet-thinking","Yes","439","3","75753","294","76489","0.01"
"2025-09-21T12:34:51.261Z","Included","claude-4-sonnet-thinking","Yes","198","4","75555","146","75903","0.01"
"2025-09-21T12:34:45.615Z","Errored, Not Charged","claude-4-sonnet-thinking","Yes","503","5","75052","161","75721","0.01"
"2025-09-21T12:34:39.845Z","Included","claude-4-sonnet-thinking","Yes","431","6","74621","417","75475","0.01"
"2025-09-21T12:34:34.387Z","Included","claude-4-sonnet-thinking","Yes","564","6","74057","188","74815","0.01"
"2025-09-21T12:34:27.389Z","Included","claude-4-sonnet-thinking","Yes","274","6","73783","211","74274","0.01"
"2025-09-21T12:34:23.653Z","Included","claude-4-sonnet-thinking","Yes","513","6","73270","128","73917","0.01"
"2025-09-21T12:34:18.750Z","Included","claude-4-sonnet-thinking","Yes","319","6","72951","164","73440","0.01"
"2025-09-21T12:34:12.525Z","Included","claude-4-sonnet-thinking","Yes","457","6","72494","180","73137","0.01"
"2025-09-21T12:34:06.172Z","Included","claude-4-sonnet-thinking","Yes","384","6","72110","148","72648","0.01"
"2025-09-21T12:34:01.031Z","Included","claude-4-sonnet-thinking","Yes","334","6","71776","182","72298","0.01"
"2025-09-21T12:33:55.753Z","Included","claude-4-sonnet-thinking","Yes","355","7","71421","191","71974","0.01"
"2025-09-21T12:33:51.179Z","Errored, Not Charged","claude-4-sonnet-thinking","Yes","101","8","71320","161","71590","0.01"
"2025-09-21T12:33:46.111Z","Included","claude-4-sonnet-thinking","Yes","472","9","70848","137","71466","0.01"
"2025-09-21T12:33:36.584Z","Included","claude-4-sonnet-thinking","Yes","495","9","70353","270","71127","0.01"
"2025-09-21T12:33:31.886Z","Included","claude-4-sonnet-thinking","Yes","298","9","70055","229","70591","0.01"
"2025-09-21T12:33:24.852Z","Included","claude-4-sonnet-thinking","Yes","387","10","69668","234","70299","0.01"
"2025-09-21T12:33:15.843Z","Included","claude-4-sonnet-thinking","Yes","815","11","68853","225","69904","0.01"
"2025-09-21T12:33:05.949Z","Included","claude-4-sonnet-thinking","Yes","496","11","68357","524","69388","0.01"
"2025-09-21T12:32:59.695Z","Included","claude-4-sonnet-thinking","Yes","2997","12","65360","293","68662","0.01"
"2025-09-21T12:31:53.260Z","Included","claude-4-sonnet-thinking","Yes","0","0","0","0","0","0.00"
"2025-09-21T12:31:46.414Z","Included","claude-4-sonnet-thinking","Yes","1479","11","63881","294","65665","0.01"
"2025-09-21T12:31:39.975Z","Included","claude-4-sonnet-thinking","Yes","53370","1016","10511","417","65314","0.05"
"2025-09-21T11:51:26.287Z","Included","claude-4-sonnet-thinking","Yes","578","10","21591","479","22658","0.004"
"2025-09-21T11:51:18.545Z","Included","claude-4-sonnet-thinking","Yes","695","11","20896","393","21995","0.004"
"2025-09-21T11:51:17.412Z","Included","claude-4-sonnet-thinking","Yes","0","0","0","0","0","0.00"
"2025-09-21T11:51:12.552Z","Errored, Not Charged","claude-4-sonnet-thinking","Yes","503","369","20393","184","21449","0.003"
"2025-09-21T11:51:11.581Z","Errored, Not Charged","claude-4-sonnet-thinking","No","0","359","0","10","369","0.000"
"2025-09-21T11:51:10.645Z","Errored, Not Charged","claude-4-sonnet-thinking","No","0","359","0","10","369","0.000"
"2025-09-21T11:51:09.344Z","Errored, Not Charged","claude-4-sonnet-thinking","No","0","359","0","10","369","0.000"
"2025-09-21T11:51:04.440Z","Included","claude-4-sonnet-thinking","Yes","491","10","19902","353","20756","0.003"
"2025-09-21T11:35:57.846Z","Errored, Not Charged","claude-4-sonnet-thinking","No","0","363","0","10","373","0.000"
"2025-09-21T11:20:51.140Z","Errored, Not Charged","claude-4-sonnet-thinking","No","0","402","0","10","412","0.000"
"2025-09-21T11:20:45.235Z","Included","claude-4-sonnet-thinking","Yes","439","10","18996","184","19629","0.002"
"2025-09-21T11:20:37.607Z","Included","claude-4-sonnet-thinking","Yes","562","10","18434","278","19284","0.003"
"2025-09-21T11:20:32.471Z","Included","claude-4-sonnet-thinking","Yes","900","10","17534","150","18594","0.003"
"2025-09-21T11:20:26.504Z","Included","claude-4-sonnet-thinking","Yes","995","11","16539","250","17795","0.003"
"2025-09-21T11:20:25.823Z","Included","claude-4-sonnet-thinking","Yes","0","0","0","0","0","0.00"
"2025-09-21T11:05:18.567Z","Errored, Not Charged","claude-4-sonnet-thinking","No","0","387","0","10","397","0.000"
"2025-09-21T10:50:14.114Z","Errored, Not Charged","claude-4-sonnet-thinking","No","0","375","0","10","385","0.000"
"2025-09-21T10:50:06.784Z","Included","claude-4-sonnet-thinking","Yes","469","11","15508","300","16288","0.003"
"2025-09-21T10:50:06.556Z","Included","claude-4-sonnet-thinking","Yes","0","0","0","0","0","0.00"
"2025-09-21T10:50:05.591Z","Included","claude-4-sonnet-thinking","Yes","0","0","0","0","0","0.00"
"2025-09-21T10:50:01.628Z","Included","claude-4-sonnet-thinking","Yes","563","10","14945","255","15773","0.003"
"2025-09-21T10:49:57.596Z","Included","claude-4-sonnet-thinking","Yes","134","10","14811","107","15062","0.002"
"2025-09-21T10:49:53.618Z","Included","claude-4-sonnet-thinking","Yes","690","10","14121","102","14923","0.002"
"2025-09-21T10:34:49.151Z","Errored, Not Charged","claude-4-sonnet-thinking","No","0","374","0","10","384","0.000"
"2025-09-21T10:19:43.196Z","Errored, Not Charged","claude-4-sonnet-thinking","No","0","370","0","10","380","0.000"
"2025-09-21T10:10:14.091Z","Included","claude-4-sonnet-thinking","Yes","577","0","108800","818","110195","0.01"
"2025-09-21T10:08:19.910Z","Included","claude-4-sonnet-thinking","Yes","10320","387","98480","333","109520","0.02"
"2025-09-21T10:07:56.559Z","Included","claude-4-sonnet-thinking","Yes","13286","385","85194","325","99190","0.02"
"2025-09-21T10:07:52.266Z","Included","claude-4-sonnet-thinking","Yes","160","0","85034","154","85348","0.01"
"2025-09-21T10:07:48.557Z","Included","claude-4-sonnet-thinking","Yes","299","0","84735","126","85160","0.01"
"2025-09-21T10:07:44.074Z","Included","claude-4-sonnet-thinking","Yes","406","0","84329","109","84844","0.01"
"2025-09-21T10:07:08.849Z","Included","claude-4-sonnet-thinking","Yes","13562","373","70767","223","84925","0.02"
"2025-09-21T10:06:52.072Z","Included","claude-4-sonnet-thinking","Yes","1521","374","69246","146","71287","0.01"
"2025-09-21T10:06:45.699Z","Included","claude-4-sonnet-thinking","Yes","1127","366","68119","155","69767","0.01"
"2025-09-21T10:06:38.174Z","Included","claude-4-sonnet-thinking","Yes","774","392","67345","144","68655","0.01"
"2025-09-21T10:06:35.545Z","Included","claude-4-sonnet-thinking","Yes","0","0","0","0","0","0.00"
"2025-09-21T10:06:33.120Z","Included","claude-4-sonnet-thinking","Yes","505","0","65690","919","67114","0.01"
"2025-09-21T10:06:25.975Z","Included","claude-4-sonnet-thinking","Yes","918","2","66427","361","67708","0.01"
"2025-09-21T10:06:23.671Z","Included","claude-4-sonnet-thinking","Yes","483","447","65207","296","66433","0.01"
"2025-09-21T10:06:18.141Z","Included","claude-4-sonnet-thinking","Yes","317","401","64890","223","65831","0.01"
"2025-09-21T10:06:16.611Z","Included","claude-4-sonnet-thinking","Yes","1097","3","65330","480","66910","0.01"
"2025-09-21T10:06:13.147Z","Included","claude-4-sonnet-thinking","Yes","368","410","64522","184","65484","0.01"
"2025-09-21T10:06:09.692Z","Included","claude-4-sonnet-thinking","Yes","1573","3","63757","668","66001","0.01"
"2025-09-21T10:06:01.373Z","Included","claude-4-sonnet-thinking","Yes","335","405","64187","235","65162","0.01"
"2025-09-21T10:05:54.920Z","Included","claude-4-sonnet-thinking","Yes","425","2","63762","198","64387","0.01"
"2025-09-21T10:05:50.731Z","Included","claude-4-sonnet-thinking","Yes","4156","3","59601","209","63969","0.01"
"2025-09-21T10:05:49.858Z","Included","claude-4-sonnet-thinking","Yes","276","2","63486","204","63968","0.01"
"2025-09-21T10:05:45.171Z","Included","claude-4-sonnet-thinking","Yes","414","2","63072","146","63634","0.01"
"2025-09-21T10:05:43.487Z","Included","claude-4-sonnet-thinking","Yes","459","3","59142","141","59745","0.01"
"2025-09-21T10:05:41.061Z","Included","claude-4-sonnet-thinking","Yes","266","2","62806","195","63269","0.01"
"2025-09-21T10:05:36.483Z","Included","claude-4-sonnet-thinking","Yes","212","3","62594","143","62952","0.01"
"2025-09-21T10:05:29.165Z","Included","claude-4-sonnet-thinking","Yes","521","4","62073","175","62773","0.01"
"2025-09-21T10:05:28.750Z","Included","claude-4-sonnet-thinking","Yes","1922","3","57220","203","59348","0.01"
"2025-09-21T10:05:25.053Z","Included","claude-4-sonnet-thinking","Yes","327","4","61746","262","62339","0.01"
"2025-09-21T10:05:20.107Z","Included","claude-4-sonnet-thinking","Yes","286","4","61460","131","61881","0.01"
"2025-09-21T10:05:19.891Z","Included","claude-4-sonnet-thinking","Yes","1287","4","55933","861","58085","0.01"
"2025-09-21T10:05:15.341Z","Errored, Not Charged","claude-4-sonnet-thinking","Yes","554","4","60906","126","61590","0.01"
"2025-09-21T10:05:08.259Z","Included","claude-4-sonnet-thinking","Yes","3151","4","57755","429","61339","0.01"
"2025-09-21T10:05:04.008Z","Included","claude-4-sonnet-thinking","Yes","323","5","57432","125","57885","0.005"
"2025-09-21T10:05:00.068Z","Included","claude-4-sonnet-thinking","Yes","3261","5","52672","716","56654","0.01"
"2025-09-21T10:04:56.592Z","Included","claude-4-sonnet-thinking","Yes","613","6","56819","221","57659","0.01"
"2025-09-21T10:04:55.244Z","Included","claude-4-sonnet-thinking","Yes","0","0","0","0","0","0.00"
"2025-09-21T10:04:53.966Z","Included","claude-4-sonnet-thinking","Yes","474","5","52198","1820","54497","0.01"
"2025-09-21T10:04:48.937Z","Included","claude-4-sonnet-thinking","Yes","1034","5","55785","323","57147","0.01"
"2025-09-21T10:04:44.315Z","Included","claude-4-sonnet-thinking","Yes","267","6","55518","104","55895","0.005"
"2025-09-21T10:04:40.307Z","Included","claude-4-sonnet-thinking","Yes","1424","5","50774","238","52441","0.01"
"2025-09-21T10:04:38.783Z","Errored, Not Charged","claude-4-sonnet-thinking","No","0","373","0","10","383","0.000"
"2025-09-21T10:04:37.978Z","Included","claude-4-sonnet-thinking","Yes","1376","7","54142","230","55755","0.01"
"2025-09-21T10:04:37.833Z","Included","claude-4-sonnet-thinking","Yes","0","0","0","0","0","0.00"
"2025-09-21T10:04:33.635Z","Included","claude-4-sonnet-thinking","Yes","592","383","12603","275","13853","0.002"
"2025-09-21T10:04:32.500Z","Included","claude-4-sonnet-thinking","Yes","0","0","0","0","0","0.00"
"2025-09-21T10:04:30.930Z","Included","claude-4-sonnet-thinking","Yes","11996","7","38778","872","51653","0.02"
"2025-09-21T10:04:30.125Z","Included","claude-4-sonnet-thinking","Yes","0","0","0","0","0","0.00"
"2025-09-21T10:04:29.156Z","Included","claude-4-sonnet-thinking","Yes","0","0","0","0","0","0.00"
"2025-09-21T10:04:28.526Z","Included","claude-4-sonnet-thinking","Yes","804","9","53338","292","54443","0.01"
"2025-09-21T10:04:27.091Z","Included","claude-4-sonnet-thinking","Yes","0","0","0","0","0","0.00"
"2025-09-21T10:04:27.070Z","Included","claude-4-sonnet-thinking","Yes","579","374","12024","284","13261","0.002"
"2025-09-21T10:04:24.215Z","Included","claude-4-sonnet-thinking","Yes","0","0","0","0","0","0.00"
"2025-09-21T10:04:22.309Z","Included","claude-4-sonnet-thinking","Yes","467","6","38311","289","39073","0.004"
"2025-09-21T10:04:19.522Z","Included","claude-4-sonnet-thinking","Yes","862","8","52476","229","53575","0.01"
"2025-09-21T10:04:15.926Z","Included","claude-4-sonnet-thinking","Yes","490","6","37821","193","38510","0.004"
"2025-09-21T10:04:14.042Z","Included","claude-4-sonnet-thinking","Yes","421","381","11603","434","12839","0.003"
"2025-09-21T10:04:08.644Z","Included","claude-4-sonnet-thinking","Yes","846","6","36975","258","38085","0.004"
"2025-09-21T10:04:08.350Z","Included","claude-4-sonnet-thinking","Yes","713","8","10890","307","11918","0.003"
"2025-09-21T10:04:07.174Z","Included","claude-4-sonnet-thinking","Yes","222","8","52254","630","53114","0.01"
"2025-09-21T10:04:03.784Z","Included","claude-4-sonnet-thinking","Yes","4352","6","32623","402","37383","0.01"
"2025-09-21T10:04:02.546Z","Included","claude-4-sonnet-thinking","Yes","295","8","51959","126","52388","0.004"
"2025-09-21T10:03:58.576Z","Included","claude-4-sonnet-thinking","Yes","1930","8","50029","133","52100","0.01"
"2025-09-21T10:03:58.145Z","Included","claude-4-sonnet-thinking","Yes","313","386","32310","120","33129","0.003"
"2025-09-21T10:03:54.170Z","Included","claude-4-sonnet-thinking","Yes","3338","9","46691","151","50189","0.01"
"2025-09-21T10:03:50.679Z","Included","claude-4-sonnet-thinking","Yes","592","7","31718","291","32608","0.004"
"2025-09-21T10:03:47.554Z","Included","claude-4-sonnet-thinking","Yes","3471","11","43220","361","47063","0.01"
"2025-09-21T10:03:45.578Z","Included","claude-4-sonnet-thinking","Yes","0","0","0","0","0","0.00"
"2025-09-21T10:03:42.656Z","Included","claude-4-sonnet-thinking","Yes","482","7","31236","129","31854","0.003"
"2025-09-21T10:03:39.969Z","Included","claude-4-sonnet-thinking","Yes","2188","11","41032","375","43606","0.01"
"2025-09-21T10:03:39.435Z","Included","claude-4-sonnet-thinking","Yes","0","0","0","0","0","0.00"
"2025-09-21T10:03:38.653Z","Included","claude-4-sonnet-thinking","Yes","0","0","0","0","0","0.00"
"2025-09-21T10:03:34.945Z","Included","claude-4-sonnet-thinking","Yes","847","11","40185","258","41301","0.005"
"2025-09-21T10:03:32.843Z","Included","claude-4-sonnet-thinking","Yes","0","0","0","0","0","0.00"
"2025-09-21T10:03:22.077Z","Included","claude-4-sonnet-thinking","Yes","28233","11","11952","439","40635","0.03"
"2025-09-21T10:03:21.700Z","Included","claude-4-sonnet-thinking","Yes","0","0","0","0","0","0.00"
"2025-09-21T10:03:20.524Z","Included","claude-4-sonnet-thinking","Yes","0","0","0","0","0","0.00"
"2025-09-21T10:03:13.471Z","Included","claude-4-sonnet-thinking","Yes","631","10","11321","188","12150","0.002"
"2025-09-21T10:03:04.934Z","Included","claude-4-sonnet-thinking","Yes","431","8","10890","634","11963","0.003"
"2025-09-21T10:02:55.644Z","Included","claude-4-sonnet-thinking","Yes","10342","383","20894","491","32110","0.01"
"2025-09-21T10:02:36.634Z","Included","claude-4-sonnet-thinking","Yes","1490","372","19404","150","21416","0.003"
"2025-09-21T10:02:28.073Z","Included","claude-4-sonnet-thinking","Yes","356","390","19048","151","19945","0.002"
"2025-09-21T10:02:22.161Z","Included","claude-4-sonnet-thinking","Yes","4664","12","14384","211","19271","0.01"
"2025-09-21T10:02:21.510Z","Included","claude-4-sonnet-thinking","Yes","0","0","0","0","0","0.00"
"2025-09-21T10:02:16.107Z","Included","claude-4-sonnet-thinking","Yes","1053","12","13331","226","14622","0.003"
"2025-09-21T10:02:15.216Z","Included","claude-4-sonnet-thinking","Yes","0","0","0","0","0","0.00"
"2025-09-21T10:02:10.199Z","Included","claude-4-sonnet-thinking","Yes","872","11","12459","180","13522","0.002"
"2025-09-21T10:02:05.292Z","Included","claude-4-sonnet-thinking","Yes","1948","8","10511","265","12732","0.003"
"2025-09-21T09:16:48.042Z","Included","auto","No","3864","0","833337","1040","838241","0.22"
"2025-09-21T09:16:22.387Z","Included","auto","No","7705","0","386857","1227","395789","0.11"
"2025-09-21T09:15:50.551Z","Included","auto","No","1808","0","269261","674","271743","0.07"
"2025-09-21T09:15:20.537Z","Included","auto","No","1371","0","260762","837","262970","0.07"
"2025-09-21T09:14:59.119Z","Errored, Not Charged","auto","No","6961","0","196605","462","204028","0.06"
"2025-09-21T09:09:55.212Z","Included","auto","No","53727","85761","1593543","25790","1758821","0.73"
"2025-09-21T09:08:57.331Z","Included","auto","No","63142","0","1028476","4318","1095936","0.36"
"2025-09-21T09:08:32.178Z","Included","auto","No","96571","0","623732","853","721156","0.28"
"2025-09-21T09:06:50.434Z","Included","auto","No","57364","0","1215527","3497","1276388","0.40"
"2025-09-21T08:46:49.384Z","Included","auto","No","94362","1226","208093","1012","304693","0.18"
"2025-09-21T08:37:45.840Z","Included","auto","No","124273","106215","2125060","19586","2375134","0.94"
"2025-09-21T08:36:28.308Z","Included","auto","No","3433","0","782933","1296","787662","0.21"
"2025-09-21T08:33:39.068Z","Errored, Not Charged","auto","No","82692","0","2744517","8523","2835732","0.84"
"2025-09-21T08:15:42.105Z","Included","auto","No","5337","0","968317","1632","975286","0.26"
"2025-09-21T08:15:06.084Z","Included","auto","No","4687","0","923101","1274","929062","0.24"
"2025-09-21T08:14:18.564Z","Included","auto","No","30115","0","662871","1349","694335","0.21"
"2025-09-21T08:13:41.066Z","Included","auto","No","232904","198686","9049574","47575","9528739","3.09"
"2025-09-21T07:52:31.059Z","Included","auto","No","16096","0","6250506","5316","6271918","1.61"
"2025-09-21T07:48:32.708Z","Included","auto","No","85565","51506","746548","10454","894073","0.42"
"2025-09-21T07:44:24.282Z","Included","auto","No","110013","0","997178","1569","1108760","0.40"
"2025-09-21T07:43:33.984Z","Included","auto","No","89319","0","6675123","5636","6770078","1.81"
"2025-09-21T05:46:26.682Z","Included","auto","No","2597","0","458093","1063","461753","0.12"
"2025-09-21T05:44:46.148Z","Included","auto","No","76951","95222","9088105","25668","9285946","2.64"
"2025-09-21T05:42:33.011Z","Included","auto","No","22040","0","832863","1286","856189","0.24"
"2025-09-21T05:41:42.697Z","Errored, Not Charged","auto","No","20779","0","352652","221","373652","0.12"
"2025-09-21T05:39:31.256Z","Included","auto","No","9626","0","1000945","2048","1012619","0.27"
"2025-09-21T05:36:55.469Z","Errored, Not Charged","auto","No","92305","47756","2693972","21106","2855139","0.98"
"2025-09-21T05:34:37.347Z","Included","auto","No","63121","0","529113","1587","593821","0.22"
"2025-09-21T05:32:39.769Z","Included","auto","No","9509","0","1001543","2030","1013082","0.27"
"2025-09-21T05:27:47.372Z","Included","auto","No","2796","0","131174","996","134966","0.04"
"2025-09-21T05:27:44.696Z","Included","auto","No","59018","77982","2028833","27480","2193313","0.84"
"2025-09-21T05:26:34.447Z","Included","auto","No","1320","0","170251","812","172383","0.05"
"2025-09-21T05:26:28.441Z","Errored, Not Charged","auto","No","35053","0","7128","73","42254","0.05"
"2025-09-21T05:24:58.201Z","Errored, Not Charged","auto","No","109889","0","681655","7965","799509","0.36"
"2025-09-21T03:11:17.032Z","Included","auto","No","265134","64500","2611905","39178","2980717","1.30"
"2025-09-21T02:57:35.167Z","Errored, Not Charged","auto","No","113070","97419","1974834","86830","2272153","1.28"
"2025-09-21T01:20:49.874Z","Included","auto","No","30643","87902","931142","11509","1061196","0.45"
"2025-09-21T01:18:41.514Z","Errored, Not Charged","auto","No","12865","0","2197262","5759","2215886","0.60"
"2025-09-21T01:16:31.614Z","Included","auto","No","91729","0","881545","2038","975312","0.35"
"2025-09-21T00:44:01.585Z","Included","auto","No","17000","2428","3218223","5222","3242873","0.86"
"2025-09-21T00:34:40.211Z","Included","auto","No","380413","111453","9144494","99366","9735726","3.50"
"2025-09-21T00:32:39.098Z","Included","auto","No","91609","0","771799","1282","864690","0.32"
"2025-09-21T00:14:44.011Z","Included","auto","No","270955","170327","3064582","82836","3588700","1.81"
"2025-09-21T00:10:31.172Z","Included","auto","No","71605","2017","2843665","4666","2921953","0.83"
"2025-09-21T00:08:21.081Z","Included","auto","No","109761","76381","2260706","27739","2474587","0.96"
"2025-09-21T00:07:37.957Z","Included","auto","No","72345","0","7129","375","79849","0.09"
"2025-09-20T23:57:01.722Z","Included","auto","No","141","0","64609","82","64832","0.02"
"2025-09-20T23:56:53.711Z","Included","auto","No","32030","0","981242","2122","1015394","0.30"
"2025-09-20T23:53:03.256Z","Included","auto","No","48552","92443","103013","21523","265531","0.33"
"2025-09-20T23:51:43.323Z","Errored, Not Charged","auto","No","107240","2626","786864","1753","898483","0.34"
"2025-09-20T23:51:02.876Z","Included","auto","No","33262","0","288068","376","321706","0.12"
"2025-09-20T23:18:58.758Z","Included","auto","No","268520","38507","6051113","32352","6390492","2.09"
"2025-09-20T23:13:56.314Z","Included","auto","No","19060","0","479449","1355","499864","0.15"
"2025-09-20T23:13:35.700Z","Errored, Not Charged","auto","No","10371","0","121548","520","132439","0.05"
"2025-09-20T23:12:15.089Z","Included","auto","No","5262","0","294862","2099","302223","0.09"
"2025-09-20T23:11:55.410Z","Errored, Not Charged","auto","No","28095","0","76222","521","104838","0.06"
"2025-09-20T23:10:20.173Z","Included","auto","No","55992","100112","2449718","11310","2617132","0.88"
"2025-09-20T23:04:27.202Z","Errored, Not Charged","auto","No","50559","270154","435506","11363","767582","0.58"
"2025-09-20T23:00:17.016Z","Errored, Not Charged","auto","No","51721","109196","681895","17958","860770","0.48"
"2025-09-20T23:00:08.470Z","Errored, Not Charged","auto","No","264","0","109424","226","109914","0.03"
"2025-09-20T22:56:42.342Z","Errored, Not Charged","auto","No","23363","3016","1822824","5766","1854969","0.52"
"2025-09-20T22:53:27.732Z","Errored, Not Charged","auto","No","88651","32295","1552500","11618","1685064","0.61"
"2025-09-20T22:40:07.092Z","Included","auto","No","214846","93683","5537872","50544","5896945","2.07"
"2025-09-20T22:34:31.559Z","Included","auto","No","109331","0","4754607","4800","4868738","1.35"
"2025-09-20T22:33:11.709Z","Errored, Not Charged","auto","No","40589","0","3713279","10524","3764392","1.04"
"2025-09-20T22:28:31.255Z","Included","auto","No","13224","0","1194340","3968","1211532","0.34"
"2025-09-20T22:28:00.040Z","Errored, Not Charged","auto","No","12326","1597","306452","1168","321543","0.10"
"2025-09-20T22:23:24.937Z","Errored, Not Charged","auto","No","97940","91184","1155053","31510","1375687","0.71"
"2025-09-20T22:19:50.622Z","Errored, Not Charged","auto","No","16531","4240","3118168","5030","3143969","0.84"
"2025-09-20T22:19:12.248Z","Errored, Not Charged","auto","No","3871","0","285878","1392","291141","0.08"
"2025-09-20T22:18:08.625Z","Included","auto","No","6037","0","902369","1617","910023","0.24"
"2025-09-20T22:15:52.495Z","Included","auto","No","7070","0","1336573","1524","1345167","0.35"
"2025-09-20T22:10:35.881Z","Included","auto","No","16339","0","2544861","4447","2565647","0.68"
"2025-09-20T22:09:51.757Z","Included","auto","No","57509","0","386492","704","444705","0.17"
"2025-09-20T22:02:51.064Z","Included","auto","No","95641","0","109182","890","205713","0.15"
"2025-09-20T21:51:22.231Z","Included","auto","No","360919","162927","4825151","75963","5424960","2.32"
"2025-09-20T21:50:32.990Z","Included","auto","No","57939","0","4924649","7587","4990175","1.35"
"2025-09-20T21:46:05.066Z","Errored, Not Charged","auto","No","54942","82556","1456421","8393","1602312","0.59"
"2025-09-20T21:43:18.486Z","Included","auto","No","108684","0","1097413","1228","1207325","0.42"
"2025-09-20T21:33:27.104Z","Included","auto","No","9273","4052","797336","5512","816173","0.25"
"2025-09-20T21:24:37.740Z","Included","auto","No","55240","0","13977007","19068","14051315","3.68"
"2025-09-20T21:22:11.819Z","Errored, Not Charged","auto","No","24232","0","1223526","2732","1250490","0.35"
"2025-09-20T21:19:51.521Z","Included","auto","No","28847","2928","703932","9530","745237","0.27"
"2025-09-20T21:14:40.992Z","Included","auto","No","29073","77110","312700","12911","431794","0.29"
"2025-09-20T21:11:54.487Z","Included","auto","No","10986","0","988307","4042","1003335","0.29"
"2025-09-20T21:07:41.125Z","Included","auto","No","2169","0","342834","1165","346168","0.10"
"2025-09-20T21:07:13.670Z","Included","auto","No","2701","0","499832","1071","503604","0.13"
"2025-09-20T21:05:23.092Z","Included","auto","No","3227","0","642418","1038","646683","0.17"
"2025-09-20T21:02:39.075Z","Errored, Not Charged","auto","No","252649","165020","10905461","61225","11384355","3.62"
"2025-09-20T21:01:51.379Z","Included","auto","No","71781","0","7138","69","78988","0.09"
"2025-09-20T20:56:32.560Z","Included","auto","No","14166","0","1247189","7042","1268397","0.37"
"2025-09-20T20:55:55.104Z","Included","auto","No","342","0","89708","281","90331","0.02"
"2025-09-20T20:55:40.730Z","Included","auto","No","82581","0","7128","247","89956","0.11"
"2025-09-20T20:52:03.607Z","Included","auto","No","100118","18273","804881","3979","927251","0.37"
"2025-09-20T20:50:28.400Z","Included","auto","No","6424","12887","658642","3399","681352","0.21"
"2025-09-20T20:47:59.765Z","Included","auto","No","96760","20688","1188703","7928","1314079","0.49"
"2025-09-20T20:45:46.766Z","Included","auto","No","5109","13464","699453","3444","721470","0.22"
"2025-09-20T20:45:05.320Z","Errored, Not Charged","auto","No","9580","5696","321968","2276","339520","0.11"
"2025-09-20T20:41:15.859Z","Included","auto","No","8711","8792","849327","5528","872358","0.27"
"2025-09-20T20:40:49.981Z","Errored, Not Charged","auto","No","768","3675","169432","1089","174964","0.05"
"2025-09-20T20:39:32.286Z","Errored, Not Charged","auto","No","214579","880","10737426","23321","10976206","3.09"
"2025-09-20T20:37:14.376Z","Included","auto","No","10356","0","1034649","4023","1049028","0.30"
"2025-09-20T20:36:32.558Z","Included","auto","No","4240","0","649032","1532","654804","0.18"
"2025-09-20T20:36:19.712Z","Included","auto","No","325","0","126880","252","127457","0.03"
"2025-09-20T20:35:41.198Z","Included","auto","No","3449","0","303863","419","307731","0.08"
"2025-09-20T20:35:09.319Z","Included","auto","No","8741","11025","515269","4163","539198","0.18"
"2025-09-20T20:29:25.806Z","Included","auto","No","24357","5625","407861","6523","444366","0.18"
"2025-09-20T20:27:27.807Z","Included","auto","No","13939","0","262218","3696","279853","0.11"
"2025-09-20T20:27:12.211Z","Errored, Not Charged","auto","No","3489","1882","57185","927","63483","0.03"
"2025-09-20T20:26:36.808Z","Errored, Not Charged","auto","No","6533","0","20551","2799","29883","0.03"
"2025-09-20T20:25:39.981Z","Errored, Not Charged","auto","No","4464","0","62622","4411","71497","0.05"
"2025-09-20T20:23:34.459Z","Included","auto","No","1656","0","130190","647","132493","0.04"
"2025-09-20T20:21:06.542Z","Included","auto","No","33138","0","880949","2410","916497","0.28"
"2025-09-20T20:20:03.559Z","Errored, Not Charged","auto","No","179487","474","6263712","16267","6459940","1.89"
"2025-09-20T20:18:34.580Z","Included","auto","No","10656","0","179686","1406","191748","0.07"
"2025-09-20T20:16:54.285Z","Included","auto","No","1766","0","102764","211","104741","0.03"
"2025-09-20T20:08:20.441Z","Included","auto","No","11224","0","63918","849","75991","0.04"
"2025-09-20T20:06:14.508Z","Included","auto","No","24402","4578","4072204","8962","4110146","1.11"
"2025-09-20T20:03:07.737Z","Errored, Not Charged","auto","No","57911","10458","389327","1623","459319","0.19"
"2025-09-20T20:02:46.321Z","Errored, Not Charged","claude-4-sonnet-1m","Yes","0","0","0","0","0","0.00"
"2025-09-20T20:02:35.945Z","Included","claude-4-sonnet-1m","Yes","469","0","217621","110","218200","0.08"
"2025-09-20T20:02:27.790Z","Included","claude-4-sonnet-1m","Yes","247","0","217374","344","217965","0.09"
"2025-09-20T20:02:19.218Z","Included","claude-4-sonnet-1m","Yes","395","0","216979","126","217500","0.08"
"2025-09-20T20:02:12.291Z","Included","claude-4-sonnet-1m","Yes","289","0","216690","211","217190","0.08"
"2025-09-20T20:02:01.632Z","Errored, Not Charged","claude-4-sonnet-1m","Yes","775","0","215915","124","216814","0.08"
"2025-09-20T20:01:53.082Z","Included","claude-4-sonnet-1m","Yes","558","0","215357","471","216386","0.09"
"2025-09-20T20:01:40.770Z","Included","claude-4-sonnet-1m","Yes","1696","0","213661","371","215728","0.09"
"2025-09-20T20:01:17.287Z","Included","claude-4-sonnet-1m","Yes","348","0","213313","290","213951","0.08"
"2025-09-20T20:00:49.277Z","Included","claude-4-sonnet-1m","Yes","345","0","212968","138","213451","0.08"
"2025-09-20T20:00:38.530Z","Included","claude-4-sonnet-1m","Yes","697","0","212271","110","213078","0.08"
"2025-09-20T20:00:25.328Z","Errored, Not Charged","claude-4-sonnet-1m","Yes","1060","0","211211","536","212807","0.09"
"2025-09-20T20:00:15.523Z","Included","claude-4-sonnet-1m","Yes","673","0","210538","763","211974","0.09"
"2025-09-20T19:59:44.388Z","Included","claude-4-sonnet-1m","Yes","371","0","210167","369","210907","0.08"
"2025-09-20T19:59:13.725Z","Included","claude-4-sonnet-1m","Yes","381","0","209786","147","210314","0.08"
"2025-09-20T19:59:00.515Z","Included","claude-4-sonnet-1m","Yes","876","0","208910","110","209896","0.08"
"2025-09-20T19:58:50.123Z","Included","claude-4-sonnet-1m","Yes","654","0","208256","677","209587","0.09"
"2025-09-20T19:58:37.666Z","Included","claude-4-sonnet-1m","Yes","824","0","207432","369","208625","0.09"
"2025-09-20T19:58:21.109Z","Included","claude-4-sonnet-1m","Yes","435","0","206997","496","207928","0.09"
"2025-09-20T19:58:08.368Z","Included","claude-4-sonnet-1m","Yes","375","0","206622","150","207147","0.08"
"2025-09-20T19:58:01.033Z","Included","claude-4-sonnet-1m","Yes","482","0","206140","110","206732","0.08"
"2025-09-20T19:57:55.145Z","Included","claude-4-sonnet-1m","Yes","373","0","205767","200","206340","0.08"
"2025-09-20T19:57:47.627Z","Included","claude-4-sonnet-1m","Yes","239","0","205528","120","205887","0.08"
"2025-09-20T19:57:40.993Z","Included","claude-4-sonnet-1m","Yes","223","0","205305","141","205669","0.08"
"2025-09-20T19:57:32.770Z","Included","claude-4-sonnet-1m","Yes","295","0","205010","121","205426","0.08"
"2025-09-20T19:57:26.759Z","Included","claude-4-sonnet-1m","Yes","263","0","204747","161","205171","0.08"
"2025-09-20T19:57:19.806Z","Errored, Not Charged","claude-4-sonnet-1m","Yes","305","0","204442","123","204870","0.08"
"2025-09-20T19:57:13.933Z","Errored, Not Charged","claude-4-sonnet-1m","Yes","243","0","204199","226","204668","0.08"
"2025-09-20T19:57:08.461Z","Included","claude-4-sonnet-1m","Yes","393","0","203806","164","204363","0.08"
"2025-09-20T19:56:56.609Z","Included","claude-4-sonnet-1m","Yes","453","0","203353","161","203967","0.08"
"2025-09-20T19:56:11.318Z","Included","claude-4-sonnet-1m","Yes","379","0","202974","177","203530","0.08"
"2025-09-20T19:55:57.500Z","Included","claude-4-sonnet-1m","Yes","1029","0","201945","110","203084","0.08"
"2025-09-20T19:55:49.356Z","Included","claude-4-sonnet-1m","Yes","804","0","201141","812","202757","0.09"
"2025-09-20T19:55:19.850Z","Included","auto","No","38354","0","3836495","6667","3881516","1.05"
"2025-09-20T19:55:18.257Z","Included","claude-4-sonnet-1m","Yes","478","0","200663","423","201564","0.08"
"2025-09-20T19:55:11.041Z","Errored, Not Charged","auto","No","753","0","215172","233","216158","0.06"
"2025-09-20T19:54:49.661Z","Included","claude-4-sonnet-1m","Yes","381","0","200282","141","200804","0.08"
"2025-09-20T19:54:39.787Z","Included","claude-4-sonnet-1m","Yes","567","0","199715","110","200392","0.08"
"2025-09-20T19:54:30.696Z","Included","claude-4-sonnet-1m","Yes","580","0","199135","396","200111","0.08"
"2025-09-20T19:54:22.548Z","Included","claude-4-sonnet-1m","Yes","404","0","198731","409","199544","0.08"
"2025-09-20T19:54:10.797Z","Errored, Not Charged","auto","No","166087","0","692474","1218","859779","0.39"
"2025-09-20T19:53:52.574Z","Included","claude-4-sonnet-1m","Yes","470","0","198261","223","198954","0.08"
"2025-09-20T19:53:21.738Z","Included","claude-4-sonnet-1m","Yes","334","0","197927","133","198394","0.08"
"2025-09-20T19:53:17.399Z","Included","auto","No","63408","0","310378","1107","374893","0.16"
"2025-09-20T19:53:10.152Z","Included","claude-4-sonnet-1m","Yes","821","0","197106","110","198037","0.08"
"2025-09-20T19:52:57.762Z","Included","claude-4-sonnet-1m","Yes","826","0","196280","606","197712","0.09"
"2025-09-20T19:52:50.534Z","Included","claude-4-sonnet-1m","Yes","648","0","195632","615","196895","0.08"
"2025-09-20T19:52:21.127Z","Included","claude-4-sonnet-1m","Yes","476","0","195156","364","195996","0.08"
"2025-09-20T19:51:50.926Z","Included","claude-4-sonnet-1m","Yes","381","0","194775","139","195295","0.07"
"2025-09-20T19:51:40.609Z","Included","claude-4-sonnet-1m","Yes","590","0","194185","110","194885","0.07"
"2025-09-20T19:51:34.344Z","Included","claude-4-sonnet-1m","Yes","367","0","193818","375","194560","0.08"
"2025-09-20T19:51:29.673Z","Included","claude-4-sonnet-1m","Yes","272","0","193546","152","193970","0.07"
"2025-09-20T19:51:23.573Z","Included","claude-4-sonnet-1m","Yes","409","0","193137","145","193691","0.07"
"2025-09-20T19:51:18.211Z","Included","claude-4-sonnet-1m","Yes","171","0","192966","124","193261","0.07"
"2025-09-20T19:51:11.344Z","Included","claude-4-sonnet-1m","Yes","370","0","192596","130","193096","0.07"
"2025-09-20T19:51:04.780Z","Included","claude-4-sonnet-1m","Yes","324","0","192272","174","192770","0.07"
"2025-09-20T19:50:56.855Z","Errored, Not Charged","claude-4-sonnet-1m","Yes","691","0","191581","145","192417","0.07"
"2025-09-20T19:50:51.411Z","Included","claude-4-sonnet-1m","Yes","389","0","191192","375","191956","0.08"
"2025-09-20T19:50:45.719Z","Errored, Not Charged","claude-4-sonnet-1m","Yes","143","0","191049","108","191300","0.07"
"2025-09-20T19:50:37.785Z","Included","claude-4-sonnet-1m","Yes","386","0","190663","125","191174","0.07"
"2025-09-20T19:50:30.288Z","Included","claude-4-sonnet-1m","Yes","619","0","190044","216","190879","0.08"
"2025-09-20T19:50:19.004Z","Included","claude-4-sonnet-1m","Yes","629","0","189415","350","190394","0.08"
"2025-09-20T19:50:12.312Z","Included","claude-4-sonnet-1m","Yes","322","0","189093","362","189777","0.08"
"2025-09-20T19:50:03.159Z","Included","claude-4-sonnet-1m","Yes","635","0","188458","136","189229","0.07"
"2025-09-20T19:49:54.783Z","Included","claude-4-sonnet-1m","Yes","641","0","187817","402","188860","0.08"
"2025-09-20T19:49:43.914Z","Included","claude-4-sonnet-1m","Yes","654","0","187163","409","188226","0.08"
"2025-09-20T19:49:36.165Z","Included","claude-4-sonnet-1m","Yes","433","0","186730","426","187589","0.08"
"2025-09-20T19:49:31.059Z","Included","claude-4-sonnet-1m","Yes","387","0","186343","220","186950","0.07"
"2025-09-20T19:49:24.689Z","Errored, Not Charged","claude-4-sonnet-1m","Yes","296","0","186047","117","186460","0.07"
"2025-09-20T19:49:18.365Z","Included","claude-4-sonnet-1m","Yes","462","0","185585","231","186278","0.07"
"2025-09-20T19:49:07.162Z","Included","claude-4-sonnet-1m","Yes","908","0","184677","176","185761","0.07"
"2025-09-20T19:48:56.803Z","Included","claude-4-sonnet-1m","Yes","922","0","183755","500","185177","0.08"
"2025-09-20T19:48:51.119Z","Included","claude-4-sonnet-1m","Yes","261","0","183494","481","184236","0.08"
"2025-09-20T19:48:44.886Z","Included","claude-4-sonnet-1m","Yes","173","0","183321","134","183628","0.07"
"2025-09-20T19:48:39.152Z","Included","claude-4-sonnet-1m","Yes","350","0","182971","101","183422","0.07"
"2025-09-20T19:48:34.756Z","Included","claude-4-sonnet-1m","Yes","173","0","182798","128","183099","0.07"
"2025-09-20T19:48:26.781Z","Included","claude-4-sonnet-1m","Yes","502","0","182296","92","182890","0.07"
"2025-09-20T19:48:19.434Z","Included","claude-4-sonnet-1m","Yes","628","0","181668","295","182591","0.07"
"2025-09-20T19:48:14.096Z","Included","claude-4-sonnet-1m","Yes","811","103","180857","335","182106","0.08"
"2025-09-20T19:47:47.827Z","Included","claude-4-sonnet-1m","Yes","218","136","180639","670","181663","0.08"
"2025-09-20T19:47:40.571Z","Errored, Not Charged","claude-4-sonnet-1m","Yes","0","0","0","0","0","0.00"
"2025-09-20T19:47:13.231Z","Included","claude-4-sonnet-1m","Yes","351","0","180288","416","181055","0.07"
"2025-09-20T19:46:47.711Z","Included","claude-4-sonnet-1m","Yes","344","0","179944","142","180430","0.07"
"2025-09-20T19:46:37.948Z","Included","claude-4-sonnet-1m","Yes","910","0","179034","109","180053","0.07"
"2025-09-20T19:46:30.864Z","Included","claude-4-sonnet-1m","Yes","620","0","178414","695","179729","0.08"
"2025-09-20T19:46:07.130Z","Included","claude-4-sonnet-1m","Yes","463","0","177951","328","178742","0.07"
"2025-09-20T19:45:39.720Z","Included","claude-4-sonnet-1m","Yes","333","0","177618","138","178089","0.07"
"2025-09-20T19:45:30.102Z","Included","claude-4-sonnet-1m","Yes","862","0","176756","109","177727","0.07"
"2025-09-20T19:45:22.935Z","Included","claude-4-sonnet-1m","Yes","634","0","176122","647","177403","0.08"
"2025-09-20T19:44:57.791Z","Included","claude-4-sonnet-1m","Yes","376","0","175746","360","176482","0.07"
"2025-09-20T19:44:32.725Z","Included","claude-4-sonnet-1m","Yes","390","0","175356","137","175883","0.07"
"2025-09-20T19:44:23.718Z","Included","claude-4-sonnet-1m","Yes","591","0","174765","119","175475","0.07"
"2025-09-20T19:44:13.771Z","Included","claude-4-sonnet-1m","Yes","696","0","174069","264","175029","0.07"
"2025-09-20T19:44:04.750Z","Included","claude-4-sonnet-1m","Yes","759","0","173310","527","174596","0.08"
"2025-09-20T19:43:57.364Z","Included","claude-4-sonnet-1m","Yes","541","111","172769","380","173801","0.07"
"2025-09-20T19:42:11.175Z","Included","claude-4-sonnet-1m","Yes","3395","0","169374","538","173307","0.09"
"2025-09-20T19:42:04.889Z","Included","claude-4-sonnet-1m","Yes","252","0","169122","77","169451","0.06"
"2025-09-20T19:41:46.952Z","Included","claude-4-sonnet-1m","Yes","585","0","168537","75","169197","0.06"
"2025-09-20T19:41:39.253Z","Included","claude-4-sonnet-1m","Yes","434","0","168103","469","169006","0.07"
"2025-09-20T19:40:51.495Z","Included","claude-4-sonnet-1m","Yes","4724","0","163379","221","168324","0.08"
"2025-09-20T19:40:46.234Z","Included","claude-4-sonnet-1m","Yes","140","0","163239","452","163831","0.07"
"2025-09-20T19:40:39.549Z","Included","claude-4-sonnet-1m","Yes","1650","0","161589","87","163326","0.07"
"2025-09-20T19:40:13.322Z","Included","claude-4-sonnet-1m","Yes","425","0","161164","244","161833","0.06"
"2025-09-20T19:39:45.252Z","Included","claude-4-sonnet-1m","Yes","334","0","160830","133","161297","0.06"
"2025-09-20T19:39:38.095Z","Included","claude-4-sonnet-1m","Yes","405","0","160425","110","160940","0.06"
"2025-09-20T19:39:30.304Z","Included","claude-4-sonnet-1m","Yes","703","0","159722","245","160670","0.07"
"2025-09-20T19:39:02.196Z","Included","claude-4-sonnet-1m","Yes","381","0","159341","392","160114","0.07"
"2025-09-20T19:38:35.592Z","Included","claude-4-sonnet-1m","Yes","345","0","158996","138","159479","0.06"
"2025-09-20T19:38:24.711Z","Included","claude-4-sonnet-1m","Yes","1023","0","157973","110","159106","0.06"
"2025-09-20T19:38:16.574Z","Included","claude-4-sonnet-1m","Yes","700","0","157273","808","158781","0.07"
"2025-09-20T19:37:50.781Z","Included","claude-4-sonnet-1m","Yes","467","0","156806","420","157693","0.07"
"2025-09-20T19:37:21.463Z","Included","claude-4-sonnet-1m","Yes","345","0","156461","143","156949","0.06"
"2025-09-20T19:37:14.508Z","Included","claude-4-sonnet-1m","Yes","421","0","156040","110","156571","0.06"
"2025-09-20T19:37:09.911Z","Included","claude-4-sonnet-1m","Yes","294","0","155746","160","156200","0.06"
"2025-09-20T19:37:04.821Z","Included","claude-4-sonnet-1m","Yes","291","0","155455","133","155879","0.06"
"2025-09-20T19:36:59.477Z","Included","claude-4-sonnet-1m","Yes","183","0","155272","128","155583","0.06"
"2025-09-20T19:36:34.621Z","Included","claude-4-sonnet-1m","Yes","477","0","154795","142","155414","0.06"
"2025-09-20T19:36:08.638Z","Included","claude-4-sonnet-1m","Yes","338","0","154457","144","154939","0.06"
"2025-09-20T19:36:02.261Z","Included","claude-4-sonnet-1m","Yes","461","0","153996","110","154567","0.06"
"2025-09-20T19:35:56.599Z","Included","claude-4-sonnet-1m","Yes","242","0","153754","164","154160","0.06"
"2025-09-20T19:35:51.705Z","Included","claude-4-sonnet-1m","Yes","257","0","153497","127","153881","0.06"
"2025-09-20T19:35:46.774Z","Included","claude-4-sonnet-1m","Yes","157","0","153340","121","153618","0.06"
"2025-09-20T19:35:41.866Z","Included","claude-4-sonnet-1m","Yes","130","0","153210","116","153456","0.06"
"2025-09-20T19:35:36.718Z","Included","claude-4-sonnet-1m","Yes","148","0","153062","89","153299","0.06"
"2025-09-20T19:35:30.430Z","Included","claude-4-sonnet-1m","Yes","518","0","152544","107","153169","0.06"
"2025-09-20T19:35:24.990Z","Included","claude-4-sonnet-1m","Yes","436","0","152108","202","152746","0.06"
"2025-09-20T19:35:17.979Z","Included","claude-4-sonnet-1m","Yes","442","0","151666","179","152287","0.06"
"2025-09-20T19:35:13.173Z","Included","claude-4-sonnet-1m","Yes","445","0","151221","192","151858","0.06"
"2025-09-20T19:35:05.281Z","Included","claude-4-sonnet-1m","Yes","441","0","150780","157","151378","0.06"
"2025-09-20T19:34:58.824Z","Included","claude-4-sonnet-1m","Yes","451","0","150329","175","150955","0.06"
"2025-09-20T19:34:53.281Z","Included","claude-4-sonnet-1m","Yes","378","0","149951","192","150521","0.06"
"2025-09-20T19:34:48.481Z","Errored, Not Charged","claude-4-sonnet-1m","Yes","249","0","149702","158","150109","0.06"
"2025-09-20T19:34:43.922Z","Included","claude-4-sonnet-1m","Yes","321","0","149381","170","149872","0.06"
"2025-09-20T19:34:38.931Z","Included","claude-4-sonnet-1m","Yes","279","0","149102","126","149507","0.06"
"2025-09-20T19:34:24.083Z","Included","claude-4-sonnet-1m","Yes","160","0","148942","121","149223","0.06"
"2025-09-20T19:33:57.947Z","Included","claude-4-sonnet-1m","Yes","470","0","148472","119","149061","0.06"
"2025-09-20T19:33:32.338Z","Included","claude-4-sonnet-1m","Yes","338","0","148134","137","148609","0.06"
"2025-09-20T19:33:22.202Z","Included","claude-4-sonnet-1m","Yes","926","0","147208","110","148244","0.06"
"2025-09-20T19:33:15.363Z","Included","claude-4-sonnet-1m","Yes","836","0","146372","711","147919","0.07"
"2025-09-20T19:33:05.801Z","Included","claude-4-sonnet-1m","Yes","183","0","146189","575","146947","0.06"
"2025-09-20T19:33:01.771Z","Included","claude-4-sonnet-1m","Yes","229","0","145960","94","146283","0.06"
"2025-09-20T19:32:55.520Z","Errored, Not Charged","claude-4-sonnet-1m","Yes","503","0","145457","104","146064","0.06"
"2025-09-20T19:32:50.385Z","Included","claude-4-sonnet-1m","Yes","506","0","144951","268","145725","0.06"
"2025-09-20T19:32:46.671Z","Included","claude-4-sonnet-1m","Yes","427","113","144524","159","145223","0.06"
"2025-09-20T19:32:41.809Z","Errored, Not Charged","claude-4-sonnet-1m","Yes","0","0","0","0","0","0.00"
"2025-09-20T19:32:35.074Z","Included","claude-4-sonnet-1m","Yes","479","0","144045","249","144773","0.06"
"2025-09-20T19:32:29.509Z","Included","claude-4-sonnet-1m","Yes","340","1","143705","287","144333","0.06"
"2025-09-20T19:32:24.053Z","Included","claude-4-sonnet-1m","Yes","895","2","142810","129","143836","0.06"
"2025-09-20T19:32:11.597Z","Included","claude-4-sonnet-1m","Yes","131888","119","10922","544","143473","0.61"
"2025-09-20T19:29:30.242Z","Errored, Not Charged","auto","No","3351","0","983771","1831","988953","0.26"
"2025-09-20T19:28:32.163Z","Errored, Not Charged","auto","No","2361","0","532955","576","535892","0.14"
"2025-09-20T19:25:37.892Z","Included","auto","No","16231","0","820056","1779","838066","0.24"
"2025-09-20T19:25:06.236Z","Included","auto","No","5829","0","154190","1153","161172","0.05"
"2025-09-20T19:23:47.175Z","Included","auto","No","10291","2101","984283","1739","998414","0.27"
"2025-09-20T19:20:08.336Z","Errored, Not Charged","auto","No","25982","0","1895639","2326","1923947","0.52"
"2025-09-20T19:19:15.084Z","Included","auto","No","23293","0","291154","1345","315792","0.11"
"2025-09-20T19:15:02.307Z","Included","auto","No","24001","107232","565776","5547","702556","0.34"
"2025-09-20T19:14:40.630Z","Included","auto","No","16525","0","2966552","7323","2990400","0.81"
"2025-09-20T19:13:27.340Z","Errored, Not Charged","auto","No","2737","0","254534","482","257753","0.07"
"2025-09-20T19:10:49.114Z","Included","auto","No","7793","0","1943600","2490","1953883","0.51"
"2025-09-20T19:10:15.583Z","Errored, Not Charged","auto","No","3959","0","614975","536","619470","0.16"
"2025-09-20T19:09:02.044Z","Errored, Not Charged","auto","No","14671","0","1120635","1018","1136324","0.30"
"2025-09-20T19:08:33.856Z","Errored, Not Charged","auto","No","40716","0","649806","505","691027","0.22"
"2025-09-20T19:04:30.339Z","Included","auto","No","182460","67837","2959403","10244","3219944","1.11"
"2025-09-20T19:01:19.890Z","Errored, Not Charged","auto","No","164937","560","2632370","4765","2802632","0.89"
"2025-09-20T18:59:11.571Z","Included","auto","No","15400","1559","963367","2711","983037","0.28"
"2025-09-20T18:59:05.475Z","Errored, Not Charged","auto","No","29573","0","24435","134","54142","0.04"
"2025-09-20T18:58:35.494Z","Included","auto","No","76550","0","3180902","10030","3267482","0.95"
"2025-09-20T18:52:57.540Z","Errored, Not Charged","auto","No","56595","396","1593654","9065","1659710","0.52"
"2025-09-20T18:48:59.985Z","Included","auto","No","69441","0","2796322","7168","2872931","0.83"
"2025-09-20T18:46:41.774Z","Errored, Not Charged","auto","No","10630","0","495940","1192","507762","0.14"
"2025-09-20T18:43:38.942Z","Included","auto","No","36761","102438","403983","19548","562730","0.39"
"2025-09-20T18:41:30.194Z","Included","auto","No","26703","0","1318931","3689","1349323","0.39"
"2025-09-20T18:40:33.913Z","Errored, Not Charged","auto","No","49806","0","317644","361","367811","0.14"
"2025-09-20T18:30:51.480Z","Included","auto","No","266097","22343","2033122","33237","2354799","1.07"
"2025-09-20T18:23:58.999Z","Included","auto","No","390236","754","2797251","6679","3194920","1.23"
"2025-09-20T18:05:33.243Z","Included","auto","No","300708","226487","6149323","50147","6726665","2.50"
"2025-09-20T18:02:55.018Z","Included","auto","No","8218","0","1476161","2560","1486939","0.39"
"2025-09-20T18:01:47.065Z","Errored, Not Charged","auto","No","16764","0","1658138","1387","1676289","0.44"
"2025-09-20T18:00:35.466Z","Errored, Not Charged","auto","No","2654","849","562716","1325","567544","0.15"
"2025-09-20T17:58:51.981Z","Included","auto","No","1540","0","273902","857","276299","0.08"
"2025-09-20T17:58:14.888Z","Errored, Not Charged","auto","No","0","0","0","0","0","0.00"
"2025-09-20T17:56:54.718Z","Errored, Not Charged","auto","No","7313","0","264153","338","271804","0.08"
"2025-09-20T17:54:11.749Z","Included","auto","No","174210","46373","396773","11857","629213","0.45"
"2025-09-20T17:51:23.599Z","Included","auto","No","28595","0","1261299","3126","1293020","0.37"
"2025-09-20T17:50:31.879Z","Errored, Not Charged","auto","No","5315","0","548858","2659","556832","0.16"
"2025-09-20T17:49:06.650Z","Errored, Not Charged","auto","No","20637","0","198324","2246","221207","0.09"
"2025-09-20T17:45:33.513Z","Errored, Not Charged","auto","No","54660","82941","2126102","16215","2279918","0.80"
"2025-09-20T17:44:54.982Z","Errored, Not Charged","auto","No","16195","0","624258","1277","641730","0.18"
"2025-09-20T17:44:22.221Z","Errored, Not Charged","auto","No","61749","0","30201","63","92013","0.09"
"2025-09-20T17:39:20.787Z","Included","auto","No","54579","0","2102572","15266","2172417","0.69"
"2025-09-20T17:38:13.725Z","Errored, Not Charged","auto","No","106","0","30201","5837","36144","0.04"
"2025-09-20T17:37:49.231Z","Errored, Not Charged","auto","No","11798","0","104048","1974","117820","0.05"
"2025-09-20T17:36:10.517Z","Included","auto","No","14938","92291","125539","7775","240543","0.21"
"2025-09-20T17:35:33.161Z","Errored, Not Charged","auto","No","0","0","0","0","0","0.00"
"2025-09-20T17:34:22.376Z","Errored, Not Charged","auto","No","3957","0","1172138","1304","1177399","0.31"
"2025-09-20T17:30:43.754Z","Included","auto","No","11695","0","3466150","3913","3481758","0.90"
"2025-09-20T17:22:01.202Z","Included","auto","No","17419","0","631870","498","649787","0.18"
"2025-09-20T17:20:25.555Z","Included","auto","No","6731","0","698200","2324","707255","0.20"
"2025-09-20T17:19:06.484Z","Errored, Not Charged","auto","No","6164","0","1484900","1901","1492965","0.39"
"2025-09-20T17:18:34.465Z","Errored, Not Charged","auto","No","3148","0","617621","1060","621829","0.16"
"2025-09-20T17:12:50.559Z","Errored, Not Charged","auto","No","106805","64436","3896092","25806","4093139","1.34"
"2025-09-20T17:06:24.264Z","Included","auto","No","139177","112","7741411","10872","7891572","2.17"
"2025-09-20T17:05:38.586Z","Errored, Not Charged","auto","No","43617","0","195882","573","240072","0.11"
"2025-09-20T17:00:23.648Z","Errored, Not Charged","auto","No","117367","95746","4198233","25494","4436840","1.47"
"2025-09-20T16:58:41.199Z","Errored, Not Charged","auto","No","183626","272800","17750","15356","489532","0.67"
"2025-09-20T16:51:19.828Z","Included","auto","No","206768","65987","4281839","21885","4576479","1.54"
"2025-09-20T16:49:51.164Z","Errored, Not Charged","auto","No","4544","0","151180","6833","162557","0.08"
"2025-09-20T16:48:28.352Z","Errored, Not Charged","auto","No","36173","0","1217617","2038","1255828","0.36"
"2025-09-20T16:47:02.886Z","Included","auto","No","19110","0","221730","664","241504","0.08"
"2025-09-20T16:45:51.916Z","Errored, Not Charged","auto","No","10022","0","879478","3506","893006","0.25"
"2025-09-20T16:44:47.437Z","Errored, Not Charged","auto","No","11571","0","583826","3634","599031","0.18"
"2025-09-20T16:41:57.109Z","Errored, Not Charged","auto","No","38830","270222","400357","18703","728112","0.60"
"2025-09-20T16:39:52.697Z","Errored, Not Charged","auto","No","33837","82975","233553","15640","366005","0.30"
"2025-09-20T16:36:20.668Z","Errored, Not Charged","auto","No","34887","0","5449211","5155","5489253","1.44"
"2025-09-20T16:31:12.807Z","Errored, Not Charged","auto","No","32635","0","1849136","5562","1887333","0.54"
"2025-09-20T16:28:38.265Z","Errored, Not Charged","auto","No","32838","0","98464","2570","133872","0.08"
"2025-09-20T16:26:56.272Z","Errored, Not Charged","auto","No","10380","0","1751281","3228","1764889","0.47"
"2025-09-20T16:19:42.382Z","Errored, Not Charged","auto","No","20246","0","3321620","3753","3345619","0.88"
"2025-09-20T16:18:30.581Z","Errored, Not Charged","auto","No","6016","0","1525962","2254","1534232","0.40"
"2025-09-20T16:17:56.877Z","Errored, Not Charged","auto","No","5486","0","685031","1173","691690","0.19"
"2025-09-20T16:15:38.267Z","Errored, Not Charged","auto","No","17690","0","2216069","3375","2237134","0.60"
"2025-09-20T16:13:15.603Z","Errored, Not Charged","auto","No","46511","0","11281","1034","58826","0.07"
"2025-09-20T16:06:32.460Z","Errored, Not Charged","auto","No","100347","0","3878109","4398","3982854","1.12"
"2025-09-20T16:06:25.193Z","Included","auto","No","0","0","0","0","0","0.00"
"2025-09-20T15:51:21.087Z","Errored, Not Charged","auto","No","202778","0","11131687","17755","11352220","3.14"
"2025-09-20T15:49:34.792Z","Errored, Not Charged","auto","No","61390","55457","11197","17356","145400","0.25"
"2025-09-20T15:44:12.827Z","Errored, Not Charged","auto","No","37780","0","2757006","16651","2811437","0.84"
"2025-09-20T15:38:46.120Z","Errored, Not Charged","auto","No","75805","47144","1031682","17770","1172401","0.52"
"2025-09-20T15:36:55.977Z","Errored, Not Charged","auto","No","23523","0","337238","9023","369784","0.17"
"2025-09-20T15:34:37.335Z","Errored, Not Charged","auto","No","1142","0","75113","9637","85892","0.08"
"2025-09-20T15:34:25.829Z","Errored, Not Charged","auto","No","5183","0","144569","475","150227","0.05"
"2025-09-20T15:33:28.848Z","Errored, Not Charged","auto","No","6596","0","63337","4281","74214","0.05"
"2025-09-20T15:32:12.325Z","Errored, Not Charged","auto","No","12118","0","51220","6213","69551","0.07"
"2025-09-20T15:30:59.888Z","Errored, Not Charged","auto","No","17179","0","258999","6171","282349","0.12"
"2025-09-20T15:29:10.195Z","Errored, Not Charged","auto","No","23149","53382","45060","9035","130626","0.16"
"2025-09-20T15:27:27.715Z","Errored, Not Charged","auto","No","45688","0","499109","8081","552878","0.23"
"2025-09-20T15:22:07.031Z","Included","auto","No","30866","0","1340214","25118","1396198","0.52"
"2025-09-20T15:21:28.384Z","Errored, Not Charged","auto","No","4998","0","280774","2081","287853","0.09"
"2025-09-20T15:20:19.324Z","Errored, Not Charged","auto","No","6145","0","252176","4512","262833","0.10"
"2025-09-20T15:17:56.730Z","Included","auto","No","34232","0","88780","129","123141","0.07"
"2025-09-20T15:12:11.688Z","Included","auto","No","49397","64330","904021","22787","1040535","0.50"
"2025-09-20T15:10:42.440Z","Included","auto","No","20618","0","645863","5100","671581","0.22"
"2025-09-20T15:08:12.972Z","Included","auto","No","12942","4533","1172650","6475","1196600","0.35"
"2025-09-20T15:05:49.534Z","Errored, Not Charged","auto","No","71652","0","544031","12103","627786","0.30"
"2025-09-20T15:02:47.946Z","Included","auto","No","13607","0","1550699","5971","1570277","0.44"
"2025-09-20T15:01:05.380Z","Errored, Not Charged","auto","No","16187","0","713479","5031","734697","0.23"
"2025-09-20T15:00:20.569Z","Errored, Not Charged","auto","No","11057","0","179718","2875","193650","0.08"
"2025-09-20T14:57:40.781Z","Errored, Not Charged","auto","No","22630","696","541246","12405","576977","0.24"
"2025-09-20T14:56:19.159Z","Errored, Not Charged","auto","No","9438","70293","102343","4182","186256","0.15"
"2025-09-20T14:55:34.672Z","Errored, Not Charged","auto","No","1856","0","329606","1465","332927","0.09"
"2025-09-20T14:54:32.235Z","Errored, Not Charged","auto","No","19989","0","289914","3953","313856","0.12"
"2025-09-20T14:50:06.462Z","Errored, Not Charged","auto","No","15813","0","526754","14682","557249","0.24"
"2025-09-20T14:44:26.427Z","Errored, Not Charged","auto","No","71819","0","1008518","23712","1104049","0.48"
"2025-09-20T14:37:34.075Z","Included","auto","No","31444","88479","222627","8145","350695","0.25"
"2025-09-20T14:35:03.072Z","Errored, Not Charged","auto","No","16858","0","1326251","5577","1348686","0.39"
"2025-09-20T14:33:44.977Z","Included","auto","No","7708","0","739101","500","747309","0.20"
"2025-09-20T14:28:43.424Z","Included","auto","No","11701","0","2843471","3417","2858589","0.75"
"2025-09-20T14:27:56.764Z","Included","auto","No","5321","0","149769","211","155301","0.05"
"2025-09-20T14:26:22.953Z","Included","auto","No","5493","0","1569655","1967","1577115","0.41"
"2025-09-20T14:26:02.639Z","Errored, Not Charged","auto","No","6115","0","488009","562","494686","0.13"
"2025-09-20T14:23:42.836Z","Included","auto","No","4098","0","806496","1439","812033","0.22"
"2025-09-20T14:22:49.238Z","Errored, Not Charged","auto","No","58178","0","828111","1423","887712","0.29"
"2025-09-20T13:54:19.837Z","Included","auto","No","6227","0","464299","2843","473369","0.14"
"2025-09-20T13:53:20.151Z","Included","auto","No","2797","0","386064","1121","389982","0.11"
"2025-09-20T13:52:16.999Z","Errored, Not Charged","auto","No","46709","0","371563","1781","420053","0.16"
"2025-09-20T05:30:34.162Z","Included","auto","No","43625","0","306152","699","350476","0.14"
"2025-09-20T05:20:14.310Z","Included","auto","No","36757","74793","107784","8819","228153","0.22"
"2025-09-20T05:19:16.056Z","Errored, Not Charged","auto","No","25384","0","272624","348","298356","0.10"
"2025-09-20T05:01:40.020Z","Included","auto","No","6815","0","1215095","1936","1223846","0.32"
"2025-09-20T04:50:22.167Z","Included","auto","No","5724","0","1368681","1364","1375769","0.36"
"2025-09-20T04:49:54.144Z","Included","auto","No","356","0","77602","194","78152","0.02"
"2025-09-20T04:27:25.582Z","Included","auto","No","5367","0","72236","246","77849","0.03"
"2025-09-20T04:25:42.043Z","Included","auto","No","5910","0","817224","1942","825076","0.22"
"2025-09-20T04:24:31.946Z","Errored, Not Charged","auto","No","64675","0","965917","2531","1033123","0.34"
"2025-09-20T01:52:45.565Z","Included","auto","No","58371","0","7128","142","65641","0.08"
"2025-09-19T22:53:57.301Z","Included","auto","No","3782","0","310782","1171","315735","0.09"
"2025-09-19T22:53:06.319Z","Included","auto","No","2514","0","236964","1066","240544","0.07"
"2025-09-19T22:52:32.399Z","Included","auto","No","635","0","174386","211","175232","0.05"
"2025-09-19T22:45:09.550Z","Included","auto","No","384","0","115358","188","115930","0.03"
"2025-09-19T22:40:40.031Z","Included","auto","No","1774","0","225337","538","227649","0.06"
"2025-09-19T22:40:37.236Z","Errored, Not Charged","auto","No","0","0","0","0","0","0.00"
"2025-09-19T22:16:39.308Z","Included","auto","No","21228","0","34315","87","55630","0.04"
"2025-09-19T22:13:07.615Z","Included","auto","No","47780","86839","1168708","20034","1323361","0.58"
"2025-09-19T21:18:32.825Z","Included","auto","No","9959","0","1787876","5107","1802942","0.49"
"2025-09-19T21:18:22.020Z","Errored, Not Charged","auto","No","2041","0","295533","199","297773","0.08"
"2025-09-19T21:17:29.161Z","Errored, Not Charged","auto","No","3782","0","956271","2401","962454","0.26"
"2025-09-19T21:15:24.313Z","Included","auto","No","1991","0","651320","662","653973","0.17"
"2025-09-19T20:52:02.640Z","Included","auto","No","4971","0","1607576","1983","1614530","0.42"
"2025-09-19T20:50:00.994Z","Included","auto","No","79986","0","600416","1843","682245","0.26"
"2025-09-19T20:47:38.228Z","Included","auto","No","5560","0","543225","1881","550666","0.15"
"2025-09-19T20:46:10.660Z","Included","auto","No","9274","0","285536","958","295768","0.09"
"2025-09-19T20:44:52.927Z","Included","auto","No","8032","0","688917","2307","699256","0.20"
"2025-09-19T20:44:18.689Z","Errored, Not Charged","auto","No","4288","0","493367","1896","499551","0.14"
"2025-09-19T20:42:38.505Z","Included","auto","No","8195","0","840871","2878","851944","0.24"
"2025-09-19T20:39:58.716Z","Included","auto","No","44738","0","1257961","4847","1307546","0.40"
"2025-09-19T19:48:23.528Z","Included","auto","No","28051","0","364796","1447","394294","0.13"
"2025-09-19T18:34:02.290Z","Included","auto","No","89303","0","2420964","2023","2512290","0.73"
"2025-09-19T18:30:22.333Z","Errored, Not Charged","auto","No","191583","352805","2054026","11880","2610294","1.27"
"2025-09-19T18:05:34.642Z","Included","auto","No","44373","0","418081","1661","464115","0.17"
"2025-09-19T18:03:54.238Z","Errored, Not Charged","auto","No","10582","0","1143487","1182","1155251","0.31"
"2025-09-19T17:53:26.114Z","Included","auto","No","11993","0","1248759","2075","1262827","0.34"
"2025-09-19T17:52:24.162Z","Included","auto","No","27003","0","211427","627","239057","0.09"
"2025-09-19T17:40:07.522Z","Included","auto","No","62589","0","1202642","2594","1267825","0.39"
"2025-09-19T17:19:03.347Z","Included","auto","No","79175","98454","733186","9204","920019","0.46"
"2025-09-19T17:17:35.259Z","Included","auto","No","8820","0","1386814","1793","1397427","0.37"
"2025-09-19T17:17:16.803Z","Errored, Not Charged","auto","No","5147","0","461407","265","466819","0.12"
"2025-09-19T17:15:50.479Z","Errored, Not Charged","auto","No","81369","0","1256008","2168","1339545","0.43"
"2025-09-19T17:10:04.299Z","Errored, Not Charged","auto","No","241667","23483","1388370","12349","1665869","0.75"
"2025-09-19T05:40:28.819Z","Included","auto","No","194895","0","1392121","2380","1589396","0.61"
"2025-09-19T05:19:40.126Z","Included","auto","No","70569","0","2232709","4888","2308166","0.68"
"2025-09-19T01:23:02.388Z","Included","auto","No","33347","94871","589323","7689","725230","0.35"
"2025-09-19T00:50:44.169Z","Included","auto","No","110750","0","2953009","3278","3067037","0.90"
"2025-09-18T22:27:57.195Z","Included","auto","No","36814","0","1887160","6257","1930231","0.56"
"2025-09-18T22:26:32.332Z","Included","auto","No","45706","0","77792","726","124224","0.08"
"2025-09-18T22:15:26.769Z","Included","auto","No","40515","330120","1744452","18498","2133585","1.01"
"2025-09-18T22:14:24.891Z","Included","auto","No","15110","0","113773","410","129293","0.05"
"2025-09-18T22:13:49.642Z","Errored, Not Charged","auto","No","82273","0","271022","300","353595","0.17"
"2025-09-18T21:32:18.731Z","Included","auto","No","24865","0","3238963","5607","3269435","0.87"
"2025-09-18T21:31:35.871Z","Errored, Not Charged","auto","No","40398","0","356044","1178","397620","0.15"
"2025-09-18T21:30:54.894Z","Errored, Not Charged","auto","No","17731","102172","53196","3940","177039","0.19"
"2025-09-18T21:07:18.284Z","Included","auto","No","35715","0","1056800","2071","1094586","0.32"
"2025-09-18T21:04:49.672Z","Included","auto","No","28771","0","1650693","4449","1683913","0.48"
"2025-09-18T21:03:59.735Z","Errored, Not Charged","auto","No","12741","0","586864","1721","601326","0.17"
"2025-09-18T20:51:17.863Z","Included","auto","No","42676","0","500799","1455","544930","0.19"
"2025-09-18T20:37:18.464Z","Included","auto","No","8521","0","33815","219","42555","0.02"
"2025-09-18T20:30:49.205Z","Included","auto","No","151518","0","4454387","7329","4613234","1.35"
"2025-09-18T20:28:17.996Z","Included","auto","No","59014","0","460876","1408","521298","0.20"
"2025-09-18T20:18:59.612Z","Included","auto","No","532","0","72527","193","73252","0.02"
"2025-09-18T20:15:51.381Z","Included","auto","No","17815","0","1004977","2466","1025258","0.29"
"2025-09-18T20:14:04.341Z","Included","auto","No","149604","0","713143","1876","864623","0.38"
"2025-09-18T19:17:59.657Z","Included","auto","No","94842","0","1248074","2241","1345157","0.44"
"2025-09-18T18:48:31.551Z","Included","auto","No","41851","0","1361246","2846","1405943","0.41"
"2025-09-18T18:44:10.567Z","Included","auto","No","1835","0","113047","391","115273","0.03"
"2025-09-18T18:43:08.273Z","Included","auto","No","7400","0","274321","2128","283849","0.09"
"2025-09-18T18:41:49.890Z","Included","auto","No","27539","103995","36192","4954","172680","0.20"
"2025-09-18T18:33:22.361Z","Included","auto","No","5510","0","867623","2443","875576","0.24"
"2025-09-18T18:30:05.285Z","Included","auto","No","84603","0","2508847","5505","2598955","0.77"
"2025-09-18T18:20:39.203Z","Included","auto","No","370535","13185","4983220","14375","5381315","1.81"
"2025-09-18T18:17:54.059Z","Errored, Not Charged","auto","No","74557","0","2334631","3265","2412453","0.70"
"2025-09-18T18:16:38.208Z","Included","auto","No","17146","0","745963","2782","765891","0.22"
"2025-09-18T18:15:48.076Z","Errored, Not Charged","auto","No","8854","0","842745","1694","853293","0.23"
"2025-09-18T18:15:33.255Z","Errored, Not Charged","auto","No","58410","0","226171","235","284816","0.13"
"2025-09-18T18:14:41.133Z","Errored, Not Charged","auto","No","62398","0","171820","822","235040","0.13"
"2025-09-18T17:34:41.184Z","Included","auto","No","20563","0","3829846","5687","3856096","1.02"
"2025-09-18T17:33:47.588Z","Included","auto","No","2036","0","400681","440","403157","0.11"
"2025-09-18T17:28:54.868Z","Included","auto","No","15475","0","1483435","2657","1501567","0.41"
"2025-09-18T17:23:02.130Z","Included","auto","No","58909","0","1134724","7238","1200871","0.40"
"2025-09-18T17:22:22.075Z","Included","auto","No","1680","0","193759","270","195709","0.05"
"2025-09-18T17:19:13.011Z","Included","auto","No","3591","0","551377","1720","556688","0.15"
"2025-09-18T17:14:15.339Z","Included","auto","No","19145","0","765469","2127","786741","0.23"
"2025-09-18T17:10:39.191Z","Errored, Not Charged","auto","No","21360","0","149785","515","171660","0.07"
"2025-09-18T17:06:37.683Z","Included","auto","No","13474","0","2905701","4986","2924161","0.77"
"2025-09-18T16:55:04.096Z","Errored, Not Charged","auto","No","93207","0","4556536","8817","4658560","1.31"
"2025-09-18T16:53:13.108Z","Included","auto","No","768","0","63298","714","64780","0.02"
"2025-09-18T16:52:51.994Z","Included","auto","No","462","0","62837","692","63991","0.02"
"2025-09-18T16:49:44.821Z","Included","auto","No","842","0","61996","384","63222","0.02"
"2025-09-18T16:49:21.002Z","Included","auto","No","289","0","62074","409","62772","0.02"
"2025-09-18T16:49:16.930Z","Errored, Not Charged","auto","No","422","0","61653","82","62157","0.02"
"2025-09-18T16:48:43.304Z","Errored, Not Charged","auto","No","2279","0","362746","1553","366578","0.10"
"2025-09-18T16:47:48.185Z","Included","auto","No","967","0","176732","478","178177","0.05"
"2025-09-18T16:47:13.116Z","Included","auto","No","1058","0","289524","828","291410","0.08"
"2025-09-18T16:46:21.271Z","Included","auto","No","3763","0","500838","1834","506435","0.14"
"2025-09-18T16:45:44.150Z","Included","auto","No","1740","0","264729","647","267116","0.07"
"2025-09-18T16:44:21.924Z","Included","auto","No","60799","94","616893","1633","679419","0.24"
"2025-09-18T16:43:45.506Z","Included","auto","No","1728","0","141996","2537","146261","0.05"
"2025-09-18T16:43:12.561Z","Included","auto","No","1513","0","274934","1451","277898","0.08"
"2025-09-18T16:42:20.130Z","Included","auto","No","5739","0","123937","868","130544","0.04"
"2025-09-18T16:41:54.783Z","Included","auto","No","3933","0","189643","1476","195052","0.06"
"2025-09-18T16:41:03.141Z","Included","auto","No","2278","0","142761","2360","147399","0.05"
"2025-09-18T16:40:32.326Z","Errored, Not Charged","auto","No","4680","0","196091","1565","202336","0.06"
"2025-09-18T16:40:02.911Z","Included","auto","No","581","0","123413","684","124678","0.04"
"2025-09-18T16:39:29.947Z","Errored, Not Charged","auto","No","16353","0","300313","1872","318538","0.11"
"2025-09-18T16:38:04.870Z","Included","auto","No","18023","112236","108120","5448","243827","0.22"
"2025-09-18T16:30:52.448Z","Included","auto","No","3432","0","433436","3437","440305","0.13"
"2025-09-18T16:30:31.833Z","Errored, Not Charged","auto","No","2039","0","104345","1449","107833","0.04"
"2025-09-18T16:29:57.760Z","Included","auto","No","2745","0","205170","2130","210045","0.07"
"2025-09-18T16:29:08.398Z","Errored, Not Charged","auto","No","5243","0","889488","2298","897029","0.24"
"2025-09-18T16:28:39.545Z","Errored, Not Charged","auto","No","9593","0","726100","591","736284","0.20"
"2025-09-18T16:27:33.359Z","Included","auto","No","6255","0","415704","2177","424136","0.12"
"2025-09-18T16:27:11.190Z","Included","auto","No","1581","0","317813","638","320032","0.09"
"2025-09-18T16:26:54.929Z","Included","auto","No","4344","0","149703","524","154571","0.05"
"2025-09-18T16:25:53.786Z","Included","auto","No","2513","0","292165","1115","295793","0.08"
"2025-09-18T16:25:42.423Z","Included","auto","No","494","0","71612","505","72611","0.02"
"2025-09-18T16:25:28.406Z","Included","auto","No","446","0","71167","420","72033","0.02"
"2025-09-18T16:25:11.380Z","Included","auto","No","2338","0","278892","595","281825","0.08"
"2025-09-18T16:24:54.653Z","Included","auto","No","838","0","67996","673","69507","0.02"
"2025-09-18T16:24:29.749Z","Included","auto","No","918","0","67079","651","68648","0.02"
"2025-09-18T16:23:55.143Z","Errored, Not Charged","auto","No","63092","0","124591","554","188237","0.11"
"2025-09-18T07:38:56.969Z","Included","auto","No","87715","105","392256","3960","484036","0.23"
"2025-09-18T07:37:40.090Z","Included","auto","No","14278","0","1324846","1683","1340807","0.36"
"2025-09-18T07:36:45.480Z","Included","auto","No","101739","0","297191","1005","399935","0.21"
"2025-09-18T07:35:13.672Z","Included","auto","No","4256","0","498476","2119","504851","0.14"
"2025-09-18T07:34:28.405Z","Errored, Not Charged","auto","No","2110","0","478083","298","480491","0.12"
"2025-09-18T07:32:51.845Z","Included","auto","No","1720","0","187008","314","189042","0.05"
"2025-09-18T07:19:23.563Z","Included","auto","No","85974","0","2562773","8048","2656795","0.80"
"2025-09-18T02:27:11.129Z","Included","auto","No","8609","0","376575","3825","389009","0.13"
"2025-09-18T02:25:39.672Z","Included","auto","No","1482","0","98971","590","101043","0.03"
"2025-09-18T02:25:36.703Z","Errored, Not Charged","auto","No","17130","0","7128","45","24303","0.02"
"2025-09-17T23:02:16.511Z","Included","auto","No","71357","0","85514","136","157007","0.11"
"2025-09-17T23:01:42.794Z","Included","auto","No","17028","0","7128","53","24209","0.02"
"2025-09-17T22:16:27.997Z","Included","auto","No","12861","96203","187240","8883","305187","0.24"
"2025-09-17T22:15:46.446Z","Included","auto","No","1186","0","323850","741","325777","0.09"
"2025-09-17T22:15:46.229Z","Included","auto","No","70943","0","83730","137","154810","0.11"
"2025-09-17T22:15:31.186Z","Errored, Not Charged","auto","No","100493","0","7128","101","107722","0.13"
"2025-09-17T20:40:32.454Z","Included","auto","No","6717","0","521408","968","529093","0.14"
"2025-09-17T20:38:22.398Z","Included","auto","No","23544","0","1006830","2480","1032854","0.30"
"2025-09-17T20:35:38.842Z","Included","auto","No","6960","0","1505249","1622","1513831","0.39"
"2025-09-17T20:33:07.126Z","Included","auto","No","34668","0","1406966","3386","1445020","0.42"
"2025-09-17T20:32:41.315Z","Included","auto","No","628","0","54657","417","55702","0.02"
"2025-09-17T20:32:22.497Z","Errored, Not Charged","auto","No","5120","0","201186","673","206979","0.06"
"2025-09-17T20:31:31.633Z","Included","auto","No","3403","0","428553","1516","433472","0.12"
"2025-09-17T20:30:35.057Z","Included","auto","No","6201","0","297711","3491","307403","0.10"
"2025-09-17T20:30:11.931Z","Errored, Not Charged","auto","No","2604","0","152012","1317","155933","0.05"
"2025-09-17T20:30:09.679Z","Errored, Not Charged","auto","No","191","0","37163","48","37402","0.01"
"2025-09-17T20:26:44.247Z","Included","auto","No","5467","0","672439","1918","679824","0.19"
"2025-09-17T20:26:04.245Z","Included","auto","No","1790","0","29926","2082","33798","0.02"
"2025-09-17T20:24:35.288Z","Included","auto","No","2230","0","27697","1630","31557","0.02"
"2025-09-17T20:23:27.898Z","Included","auto","No","6503","0","21195","2081","29779","0.03"
"2025-09-17T20:21:16.037Z","Included","auto","No","14489","106100","75274","6320","202183","0.21"
"2025-09-17T20:19:21.359Z","Included","auto","No","20288","0","362709","3543","386540","0.14"
"2025-09-17T20:17:50.158Z","Errored, Not Charged","auto","No","16354","94648","141032","7998","260032","0.22"
"2025-09-17T20:15:17.194Z","Errored, Not Charged","auto","No","15447","0","1895836","7261","1918544","0.54"
"2025-09-17T20:13:23.050Z","Errored, Not Charged","auto","No","78674","0","1080227","5726","1164627","0.40"
"2025-09-17T20:10:12.540Z","Included","auto","No","56027","0","1090470","12266","1158763","0.42"
"2025-09-17T20:06:11.001Z","Included","auto","No","57819","0","436655","960","495434","0.19"
"2025-09-17T20:03:47.996Z","Included","auto","No","38262","0","955050","2528","995840","0.30"
"2025-09-17T19:35:55.504Z","Included","auto","No","4958","0","10037","76","15071","0.01"
"2025-09-17T19:33:16.688Z","Included","auto","No","89808","0","1217384","2517","1309709","0.43"
"2025-09-17T18:54:53.517Z","Included","auto","No","2264","0","441820","1304","445388","0.12"
"2025-09-17T18:40:23.490Z","Included","auto","No","87757","0","1659063","9365","1756185","0.58"
"2025-09-17T18:39:29.250Z","Included","auto","No","6459","0","765623","1187","773269","0.21"
"2025-09-17T18:37:21.286Z","Errored, Not Charged","auto","No","41817","0","883654","3851","929322","0.30"
"2025-09-17T18:36:32.143Z","Errored, Not Charged","auto","No","1907","0","271233","163","273303","0.07"
"2025-09-17T18:32:21.294Z","Included","auto","No","82570","0","3056651","4422","3143643","0.89"
"2025-09-17T18:21:35.014Z","Included","auto","No","117216","59555","7807349","20109","8004229","2.29"
"2025-09-17T18:14:35.513Z","Included","auto","No","77609","0","997524","17735","1092868","0.45"
"2025-09-17T18:10:38.117Z","Errored, Not Charged","auto","No","52803","0","1089475","3363","1145641","0.36"
"2025-09-17T18:09:55.482Z","Errored, Not Charged","auto","No","107193","0","368186","147","475526","0.23"
"2025-09-17T17:58:23.137Z","Included","auto","No","11967","0","1302098","4361","1318426","0.37"
"2025-09-17T17:57:49.067Z","Errored, Not Charged","auto","No","30556","0","535350","1283","567189","0.18"
"2025-09-17T17:57:42.907Z","Included","auto","No","0","0","0","0","0","0.00"
"2025-09-17T17:55:19.889Z","Included","auto","No","53550","0","718952","1545","774047","0.26"
"2025-09-17T17:53:13.269Z","Errored, Not Charged","auto","No","65423","0","1054745","1441","1121609","0.35"
"2025-09-17T17:48:23.460Z","Included","auto","No","16043","0","4552610","5051","4573704","1.19"
"2025-09-17T17:48:13.908Z","Errored, Not Charged","auto","No","662","0","183937","344","184943","0.05"
"2025-09-17T17:47:15.636Z","Errored, Not Charged","auto","No","4745","0","1251231","1547","1257523","0.33"
"2025-09-17T17:46:29.916Z","Errored, Not Charged","auto","No","2000","0","1117523","823","1120346","0.29"
"2025-09-17T17:44:57.352Z","Errored, Not Charged","auto","No","78001","0","1163871","2265","1244137","0.40"
"2025-09-17T17:43:22.307Z","Included","auto","No","19571","0","58748","1036","79355","0.05"
"2025-09-17T17:01:33.409Z","Included","auto","No","12948","0","807862","8559","829369","0.27"
"2025-09-17T16:57:44.598Z","Included","auto","No","950","0","74348","828","76126","0.02"
"2025-09-17T16:54:11.248Z","Errored, Not Charged","auto","No","88975","21331","757629","16238","884173","0.42"
"2025-09-17T16:44:11.917Z","Included","auto","No","137671","31409","2611968","28533","2809581","1.04"
"2025-09-17T16:31:56.275Z","Included","auto","No","134594","0","3283337","40022","3457953","1.23"
"2025-09-17T16:26:03.838Z","Included","auto","No","32923","0","275615","8158","316696","0.16"
"2025-09-17T16:24:07.523Z","Included","auto","No","1748","0","136692","333","138773","0.04"
"2025-09-17T16:22:50.515Z","Errored, Not Charged","auto","No","13088","0","1151711","2151","1166950","0.32"
"2025-09-17T16:19:46.281Z","Included","auto","No","47404","0","834687","3441","885532","0.29"
"2025-09-17T16:18:33.154Z","Included","auto","No","15575","0","350807","534","366916","0.11"
"2025-09-17T16:16:05.223Z","Included","auto","No","14421","0","1493916","5184","1513521","0.42"
"2025-09-17T16:14:51.623Z","Errored, Not Charged","auto","No","47942","0","478418","1084","527444","0.19"
"2025-09-17T16:14:04.913Z","Included","auto","No","2666","0","209583","1487","213736","0.06"
"2025-09-17T16:13:40.955Z","Errored, Not Charged","auto","No","7346","0","93239","510","101095","0.04"
"2025-09-17T16:10:16.495Z","Errored, Not Charged","auto","No","15954","0","37655","5996","59605","0.07"
"2025-09-17T16:06:54.367Z","Included","auto","No","10074","0","567953","6041","584068","0.19"
"2025-09-17T16:02:24.659Z","Included","auto","No","27543","0","590186","6381","624110","0.22"
"2025-09-17T15:59:50.272Z","Included","auto","No","16344","0","693898","7016","717258","0.24"
"2025-09-17T15:59:19.366Z","Errored, Not Charged","auto","No","49566","0","310788","195","360549","0.14"
"2025-09-17T15:58:05.437Z","Included","auto","No","3044","0","318618","1531","323193","0.09"
"2025-09-17T15:57:36.957Z","Errored, Not Charged","auto","No","52399","0","131129","1595","185123","0.11"
"2025-09-17T15:56:20.211Z","Errored, Not Charged","auto","No","35279","0","542589","3990","581858","0.20"
"2025-09-17T15:54:41.444Z","Errored, Not Charged","auto","No","12882","0","54668","5919","73469","0.07"
"2025-09-17T15:52:39.784Z","Included","auto","No","3065","0","474183","911","478159","0.13"
"2025-09-17T15:52:10.466Z","Included","auto","No","2560","0","382459","648","385667","0.10"
"2025-09-17T15:51:15.095Z","Included","auto","No","27709","0","696136","1924","725769","0.22"
"2025-09-17T15:49:58.459Z","Included","auto","No","4930","0","795403","1496","801829","0.21"
"2025-09-17T15:48:59.861Z","Errored, Not Charged","auto","No","55380","0","624772","2032","682184","0.24"
"2025-09-17T15:47:27.015Z","Included","auto","No","6676","0","657351","2427","666454","0.19"
"2025-09-17T15:47:11.382Z","Errored, Not Charged","auto","No","2066","0","100074","923","103063","0.03"
"2025-09-17T15:46:48.043Z","Errored, Not Charged","auto","No","3566","0","191377","782","195725","0.06"
"2025-09-17T15:46:26.880Z","Errored, Not Charged","auto","No","32831","0","13316","1486","47633","0.05"
"2025-09-17T15:45:28.832Z","Included","auto","No","38681","0","331458","1577","371716","0.14"
"2025-09-17T15:38:23.498Z","Included","auto","No","38668","92602","937848","6282","1075400","0.44"
"2025-09-17T15:37:48.811Z","Errored, Not Charged","auto","No","2135","0","484240","1176","487551","0.13"
"2025-09-17T15:37:32.249Z","Errored, Not Charged","auto","No","1596","0","285816","346","287758","0.08"
"2025-09-17T15:37:05.209Z","Errored, Not Charged","auto","No","15983","0","359129","740","375852","0.11"
"2025-09-17T15:35:57.489Z","Errored, Not Charged","auto","No","84698","0","1436502","1463","1522663","0.47"
"2025-09-17T15:29:34.928Z","Included","auto","No","29857","0","48748","151","78756","0.05"
"2025-09-17T15:22:38.249Z","Included","auto","No","29635","0","4102908","9298","4141841","1.12"
"2025-09-17T15:22:02.042Z","Errored, Not Charged","auto","No","41229","0","212456","976","254661","0.11"
"2025-09-17T15:16:12.466Z","Included","auto","No","125214","101696","2412456","26274","2665640","1.04"
"2025-09-17T15:14:42.853Z","Included","auto","No","2496","0","119434","1277","123207","0.04"
"2025-09-17T15:12:26.404Z","Included","auto","No","29917","0","853384","6256","889557","0.29"
"2025-09-17T15:09:55.921Z","Included","auto","No","8935","0","1551182","1745","1561862","0.41"
"2025-09-17T15:09:22.960Z","Included","auto","No","3149","0","344373","561","348083","0.09"
"2025-09-17T15:08:05.231Z","Errored, Not Charged","auto","No","2386","0","585619","671","588676","0.15"
"2025-09-17T15:07:27.849Z","Included","auto","No","1321","0","245631","421","247373","0.07"
"2025-09-17T15:06:15.835Z","Included","auto","No","11500","0","934013","2473","947986","0.26"
"2025-09-17T15:03:43.611Z","Included","auto","No","62783","0","867478","1776","932037","0.31"
"2025-09-17T14:58:49.108Z","Errored, Not Charged","auto","No","63691","0","2788069","4434","2856194","0.80"
"2025-09-17T14:55:53.994Z","Included","auto","No","12168","0","275766","921","288855","0.09"
"2025-09-17T14:50:42.330Z","Included","auto","No","11070","0","1293676","3106","1307852","0.36"
"2025-09-17T14:45:02.457Z","Included","auto","No","21852","0","1088967","12344","1123163","0.37"
"2025-09-17T14:43:20.139Z","Included","auto","No","12344","0","117414","2702","132460","0.06"
"2025-09-17T14:41:13.050Z","Errored, Not Charged","auto","No","28620","0","7128","67","35815","0.04"
"2025-09-17T14:23:23.173Z","Included","auto","No","103378","0","5356911","5956","5466245","1.50"
"2025-09-17T13:40:10.488Z","Included","auto","No","84541","0","189637","218","274396","0.15"
"2025-09-17T07:39:33.837Z","Included","auto","No","67085","0","3206766","6148","3279999","0.92"
"2025-09-17T07:34:23.079Z","Included","auto","No","0","64185","496384","3529","564098","0.23"
"2025-09-17T07:20:29.965Z","Errored, Not Charged","auto","No","47965","0","2940741","8160","2996866","0.84"
"2025-09-17T07:20:24.343Z","Errored, Not Charged","auto","No","0","0","0","0","0","0.00"
"2025-09-17T07:13:58.060Z","Errored, Not Charged","auto","No","205078","0","1610503","12615","1828196","0.73"
"2025-09-17T06:55:44.331Z","Errored, Not Charged","auto","No","92794","0","1630064","4680","1727538","0.55"
"2025-09-17T06:48:16.475Z","Errored, Not Charged","auto","No","189913","22806","3448905","21029","3682653","1.25"
"2025-09-17T06:45:01.894Z","Included","auto","No","42378","0","1080067","6046","1128491","0.36"
"2025-09-17T06:41:43.716Z","Errored, Not Charged","auto","No","34149","97497","848036","15106","994788","0.47"
"2025-09-17T06:37:54.244Z","Errored, Not Charged","auto","No","74284","0","569253","12846","656383","0.31"
"2025-09-17T06:32:16.377Z","Errored, Not Charged","auto","No","88412","101498","3085520","18757","3294187","1.12"
"2025-09-17T06:31:33.206Z","Errored, Not Charged","auto","No","659","0","221657","370","222686","0.06"
"2025-09-17T06:29:44.752Z","Included","auto","No","81838","0","451055","4349","537242","0.24"
"2025-09-17T06:24:34.702Z","Included","auto","No","113072","105450","1515821","20795","1755138","0.78"
"2025-09-17T06:22:04.520Z","Included","auto","No","6652","0","220031","2528","229211","0.08"
"2025-09-17T06:21:19.480Z","Errored, Not Charged","auto","No","102006","0","216811","1883","320700","0.19"
"2025-09-17T06:01:43.567Z","Included","auto","No","357174","109823","8094644","33663","8595304","2.81"
"2025-09-17T06:00:35.685Z","Included","auto","No","14011","0","60341","3267","77619","0.05"
"2025-09-17T05:59:38.028Z","Errored, Not Charged","auto","No","15059","0","121302","1085","137446","0.06"
"2025-09-17T05:50:01.847Z","Included","auto","No","3583","0","698785","1030","703398","0.19"
"2025-09-17T05:49:05.054Z","Errored, Not Charged","auto","No","7192","0","371017","246","378455","0.10"
"2025-09-17T05:42:45.614Z","Included","auto","No","118091","60725","3212621","10882","3402319","1.09"
"2025-09-17T05:38:08.666Z","Errored, Not Charged","auto","No","101861","1106","3276601","7985","3387553","1.00"
"2025-09-17T05:28:23.951Z","Included","auto","No","23887","0","1232081","2368","1258336","0.35"
"2025-09-17T05:27:56.040Z","Included","auto","No","33172","0","7138","78","40388","0.04"
"2025-09-17T05:22:33.896Z","Included","auto","No","50230","0","120176","743","171149","0.10"
"2025-09-17T05:19:04.964Z","Included","auto","No","11761","0","1507571","3272","1522604","0.41"
"2025-09-17T05:18:50.635Z","Errored, Not Charged","auto","No","2852","0","211732","731","215315","0.06"
"2025-09-17T05:18:10.041Z","Errored, Not Charged","auto","No","34083","0","316662","1142","351887","0.13"
"2025-09-17T05:04:56.582Z","Included","auto","No","22397","0","293980","2272","318649","0.12"
"2025-09-17T05:01:15.733Z","Included","auto","No","741","0","33292","298","34331","0.01"
"2025-09-17T05:00:46.818Z","Included","auto","No","7481","0","176088","976","184545","0.06"
"2025-09-17T04:54:29.701Z","Included","auto","No","22034","0","2812004","3931","2837969","0.75"
"2025-09-17T04:54:08.521Z","Included","auto","No","544","0","88455","182","89181","0.02"
"2025-09-17T04:52:04.327Z","Errored, Not Charged","auto","No","11250","0","1931477","4732","1947459","0.53"
"2025-09-17T04:51:08.468Z","Errored, Not Charged","auto","No","4514","0","967550","830","972894","0.25"
"2025-09-17T04:41:26.788Z","Included","auto","No","1580","0","359372","268","361220","0.09"
"2025-09-17T04:41:05.119Z","Included","auto","No","1942","0","279695","1182","282819","0.08"
"2025-09-17T04:39:11.401Z","Included","auto","No","16074","0","1218554","2974","1237602","0.34"
"2025-09-17T04:38:57.427Z","Included","auto","No","921","0","176550","407","177878","0.05"
"2025-09-17T04:38:17.138Z","Included","auto","No","5731","0","542247","1049","549027","0.15"
"2025-09-17T04:37:41.700Z","Errored, Not Charged","auto","No","3964","0","352879","905","357748","0.10"
"2025-09-17T04:30:26.642Z","Included","auto","No","6553","0","395698","1280","403531","0.11"
"2025-09-17T04:29:52.231Z","Included","auto","No","400","0","41802","141","42343","0.01"
"2025-09-17T04:29:08.497Z","Included","auto","No","19445","0","285082","1494","306021","0.10"
"2025-09-17T04:28:01.239Z","Included","auto","No","7650","0","292372","1759","301781","0.09"
"2025-09-17T04:27:41.807Z","Errored, Not Charged","auto","No","4551","0","224329","714","229594","0.07"
"2025-09-17T04:26:53.686Z","Errored, Not Charged","auto","No","11002","70095","11225","7284","99606","0.15"
"2025-09-17T04:26:04.068Z","Included","auto","No","20976","0","963579","916","985471","0.27"
"2025-09-17T04:23:52.133Z","Included","auto","No","12958","0","500282","5067","518307","0.17"
"2025-09-17T04:22:57.349Z","Errored, Not Charged","auto","No","5849","0","187748","4368","197965","0.08"
"2025-09-17T04:22:11.649Z","Errored, Not Charged","auto","No","747","0","90275","3395","94417","0.04"
"2025-09-17T04:21:49.555Z","Errored, Not Charged","auto","No","2869","0","354675","1265","358809","0.10"
"2025-09-17T04:17:46.339Z","Included","auto","No","17022","0","1172691","3263","1192976","0.33"
"2025-09-17T04:15:55.800Z","Included","auto","No","4380","0","421205","507","426092","0.11"
"2025-09-17T04:15:13.942Z","Errored, Not Charged","auto","No","10230","0","190377","4019","204626","0.08"
"2025-09-17T04:12:56.080Z","Included","auto","No","58401","0","426736","5849","490986","0.21"
"2025-09-17T04:12:33.330Z","Errored, Not Charged","auto","No","4858","0","325563","1191","331612","0.09"
"2025-09-17T04:11:16.600Z","Included","auto","No","6846","0","518490","4097","529433","0.16"
"2025-09-17T04:10:33.867Z","Included","auto","No","16977","0","278023","3360","298360","0.11"
"2025-09-17T04:08:20.411Z","Included","auto","No","32383","317948","536621","21465","908417","0.70"
"2025-09-17T04:06:43.083Z","Errored, Not Charged","auto","No","0","0","0","0","0","0.00"
"2025-09-17T04:03:14.335Z","Errored, Not Charged","auto","No","27430","0","346674","1005","375109","0.13"
"2025-09-17T04:02:08.955Z","Errored, Not Charged","auto","No","12894","0","1488967","3352","1505213","0.41"
"2025-09-17T04:01:21.337Z","Errored, Not Charged","auto","No","4070","0","533502","2936","540508","0.16"
"2025-09-17T04:01:01.838Z","Errored, Not Charged","auto","No","487","0","103891","1345","105723","0.03"
"2025-09-17T04:00:01.514Z","Errored, Not Charged","auto","No","99870","0","617674","2299","719843","0.29"
"2025-09-17T03:59:37.252Z","Errored, Not Charged","auto","No","1324","0","298697","1304","301325","0.08"
"2025-09-17T03:59:02.728Z","Included","auto","No","3616","0","389044","592","393252","0.11"
"2025-09-17T03:57:48.742Z","Included","auto","No","14344","0","713592","1324","729260","0.20"
"2025-09-17T03:53:57.187Z","Included","auto","No","56611","55952","499348","13242","625153","0.34"
"2025-09-17T03:52:05.976Z","Included","auto","No","85623","0","1317413","2267","1405303","0.45"
"2025-09-17T03:26:55.402Z","Included","auto","No","55272","350233","348171","16336","770012","0.69"
"2025-09-17T03:02:43.797Z","Included","auto","No","48467","0","1988898","5315","2042680","0.59"
"2025-09-17T03:02:20.081Z","Errored, Not Charged","auto","No","44871","0","45274","1413","91558","0.08"
"2025-09-17T03:00:46.941Z","Included","auto","No","82357","0","966689","2457","1051503","0.36"
"2025-09-17T02:28:01.615Z","Included","auto","No","109953","0","1796697","1990","1908640","0.60"
"2025-09-17T01:54:08.148Z","Included","auto","No","67696","350873","882509","9261","1310339","0.80"
"2025-09-17T01:06:13.332Z","Included","auto","No","199467","0","2786589","9510","2995566","1.00"
"2025-09-17T01:00:27.726Z","Errored, Not Charged","auto","No","82753","0","646036","778","729567","0.27"
"2025-09-17T00:06:18.786Z","Included","auto","No","339893","101222","4822192","22797","5286104","1.89"
"2025-09-17T00:04:29.680Z","Included","auto","No","73562","0","783849","1684","859095","0.30"
"2025-09-17T00:03:07.565Z","Included","auto","No","14092","0","906480","2778","923350","0.26"
"2025-09-16T23:56:14.617Z","Errored, Not Charged","auto","No","231020","135421","2619941","45298","3031680","1.38"
"2025-09-16T23:56:14.572Z","Included","auto","No","8497","0","362521","1563","372581","0.11"
"2025-09-16T23:54:27.402Z","Errored, Not Charged","auto","No","42787","0","372603","10042","425432","0.21"
"2025-09-16T23:52:41.454Z","Included","auto","No","11234","328544","250775","7202","597755","0.53"
"2025-09-16T23:52:09.071Z","Errored, Not Charged","auto","No","9065","0","159865","3341","172271","0.07"
"2025-09-16T23:50:06.636Z","Included","auto","No","3562","0","299149","629","303340","0.08"
"2025-09-16T23:47:52.145Z","Included","auto","No","21881","0","352927","798","375606","0.12"
"2025-09-16T23:47:29.487Z","Included","auto","No","8545","71089","63178","8405","151217","0.17"
"2025-09-16T23:47:02.671Z","Errored, Not Charged","auto","No","992","0","111594","66","112652","0.03"
"2025-09-16T23:44:38.804Z","Included","auto","No","16083","0","1031105","5635","1052823","0.31"
"2025-09-16T23:44:23.504Z","Errored, Not Charged","auto","No","33455","0","232825","505","266785","0.10"
"2025-09-16T23:43:21.289Z","Errored, Not Charged","auto","No","3264","0","901944","1283","906491","0.24"
"2025-09-16T23:42:25.238Z","Included","auto","No","88470","0","717719","8322","814511","0.34"
"2025-09-16T23:41:41.615Z","Included","auto","No","104265","0","1163887","1812","1269964","0.43"
"2025-09-16T22:30:08.669Z","Included","auto","No","82808","0","845885","1647","930340","0.32"
"2025-09-16T22:30:04.622Z","Errored, Not Charged","auto","No","2167","0","79624","189","81980","0.02"
"2025-09-16T22:29:36.608Z","Errored, Not Charged","auto","No","5072","0","461602","1894","468568","0.13"
"2025-09-16T22:29:28.870Z","Errored, Not Charged","auto","No","2718","0","145534","475","148727","0.04"
"2025-09-16T22:28:14.894Z","Errored, Not Charged","auto","No","156118","77827","351749","4012","589706","0.40"
"2025-09-16T21:59:50.441Z","Included","auto","No","74643","0","217834","743","293220","0.15"
"2025-09-16T21:57:44.033Z","Included","auto","No","7033","0","353473","3689","364195","0.12"
"2025-09-16T21:56:59.269Z","Included","auto","No","13537","0","239266","2206","255009","0.09"
"2025-09-16T21:56:14.729Z","Included","auto","No","4878","0","393700","2350","400928","0.12"
"2025-09-16T21:54:59.918Z","Included","auto","No","8736","0","216475","2524","227735","0.08"
"2025-09-16T21:51:19.684Z","Included","auto","No","14393","0","475574","2409","492376","0.15"
"2025-09-16T21:50:25.742Z","Included","auto","No","4302","0","327301","2201","333804","0.10"
"2025-09-16T21:49:05.933Z","Included","auto","No","3463","0","245771","1842","251076","0.08"
"2025-09-16T21:47:31.831Z","Included","auto","No","36132","0","259437","1198","296767","0.12"
"2025-09-16T21:46:39.723Z","Included","auto","No","1890","0","170389","409","172688","0.05"
"2025-09-16T21:45:52.433Z","Included","auto","No","66587","58970","4540050","15918","4681525","1.39"
"2025-09-16T21:45:29.885Z","Included","auto","No","32770","148475","135980","12335","329560","0.33"
"2025-09-16T21:40:41.184Z","Errored, Not Charged","auto","No","22207","0","2114279","4884","2141370","0.59"
"2025-09-16T21:39:12.852Z","Included","auto","No","10234","0","537880","849","548963","0.15"
"2025-09-16T21:38:41.233Z","Included","auto","No","2464","0","214064","1448","217976","0.07"
"2025-09-16T21:38:05.219Z","Included","auto","No","6255","0","340846","1626","348727","0.10"
"2025-09-16T21:37:33.344Z","Included","auto","No","3397","0","454981","1349","459727","0.13"
"2025-09-16T21:35:50.975Z","Included","auto","No","36290","0","629682","4225","670197","0.23"
"2025-09-16T21:34:21.028Z","Included","auto","No","11258","187488","141670","3161","343577","0.30"
"2025-09-16T21:32:47.103Z","Included","auto","No","13752","83916","526380","5053","629101","0.28"
"2025-09-16T21:32:07.600Z","Errored, Not Charged","auto","No","4360","0","453060","3072","460492","0.14"
"2025-09-16T21:31:37.118Z","Errored, Not Charged","auto","No","1145","0","109814","2732","113691","0.05"
"2025-09-16T21:31:14.593Z","Errored, Not Charged","auto","No","102755","0","7060","801","110616","0.14"
"2025-09-16T21:22:55.640Z","Errored, Not Charged","auto","No","31907","0","1253817","9195","1294919","0.41"
"2025-09-16T21:22:11.849Z","Included","auto","No","3535","0","541781","1145","546461","0.15"
"2025-09-16T21:21:40.998Z","Included","auto","No","17401","0","114353","297","132051","0.05"
"2025-09-16T21:18:48.138Z","Included","auto","No","67238","0","4721104","5151","4793493","1.30"
"2025-09-16T21:18:02.153Z","Included","auto","No","63409","0","796042","790","860241","0.28"
"2025-09-16T21:08:36.316Z","Included","auto","No","15474","0","970541","1842","987857","0.27"
"2025-09-16T21:04:55.270Z","Included","auto","No","52915","0","126381","505","179801","0.10"
"2025-09-16T21:00:26.971Z","Errored, Not Charged","auto","No","13647","0","23836","99","37582","0.02"
"2025-09-16T20:48:39.317Z","Included","auto","No","78185","0","5183846","4446","5266477","1.42"
"2025-09-16T20:46:49.631Z","Included","auto","No","10305","0","354558","1012","365875","0.11"
"2025-09-16T20:38:01.808Z","Errored, Not Charged","auto","No","86933","0","1946118","2528","2035579","0.61"
"2025-09-16T20:36:36.953Z","Errored, Not Charged","auto","No","1706","0","295934","609","298249","0.08"
"2025-09-16T20:35:44.012Z","Included","auto","No","26989","0","952546","1422","980957","0.28"
"2025-09-16T20:35:17.784Z","Included","auto","No","7286","0","244676","361","252323","0.07"
"2025-09-16T20:34:47.952Z","Included","auto","No","3854","0","489983","766","494603","0.13"
"2025-09-16T20:34:03.815Z","Included","auto","No","38387","2841","1164200","3934","1209362","0.37"
"2025-09-16T20:33:18.603Z","Errored, Not Charged","auto","No","10618","0","771463","1026","783107","0.21"
"2025-09-16T20:32:54.213Z","Included","auto","No","2486","0","65090","425","68001","0.02"
"2025-09-16T20:32:07.273Z","Included","auto","No","1999","0","91951","1760","95710","0.04"
"2025-09-16T20:31:15.945Z","Included","auto","No","1392","0","58183","316","59891","0.02"
"2025-09-16T20:29:49.435Z","Included","auto","No","5142","0","136365","294","141801","0.04"
"2025-09-16T20:26:59.994Z","Errored, Not Charged","auto","No","61627","0","1722316","4283","1788226","0.53"
"2025-09-15T22:11:47.392Z","Included","auto","No","7892","55780","864520","3053","931245","0.31"
"2025-09-15T22:10:31.559Z","Included","auto","No","4672","54563","539985","4104","603324","0.23"
"2025-09-15T22:09:27.977Z","Included","auto","No","7258","0","338525","2769","348552","0.11"
"2025-09-15T22:08:12.526Z","Included","auto","No","3516","0","162312","2974","168802","0.06"
"2025-09-15T22:08:06.404Z","Errored, Not Charged","auto","No","7859","0","72863","219","80941","0.03"
"2025-09-15T22:07:38.141Z","Included","auto","No","1709","0","315664","773","318146","0.09"
"2025-09-15T22:07:12.557Z","Included","auto","No","7456","0","296724","1435","305615","0.09"
"2025-09-15T22:06:42.687Z","Errored, Not Charged","auto","No","1884","0","208189","2418","212491","0.07"
"2025-09-15T22:05:40.740Z","Included","auto","No","24535","6168","448522","2827","482052","0.17"
"2025-09-15T22:05:09.217Z","Included","auto","No","5029","0","318374","1210","324613","0.09"
"2025-09-15T22:04:33.555Z","Errored, Not Charged","auto","No","10875","0","169315","2338","182528","0.07"
"2025-09-15T22:04:07.646Z","Errored, Not Charged","auto","No","3373","0","286978","1783","292134","0.09"
"2025-09-15T22:03:47.979Z","Errored, Not Charged","auto","No","2711","0","315077","979","318767","0.09"
"2025-09-15T22:03:05.553Z","Errored, Not Charged","auto","No","15835","74011","106609","6323","202778","0.18"
"2025-09-15T22:02:30.930Z","Included","auto","No","992","0","337426","397","338815","0.09"
"2025-09-15T22:01:43.075Z","Included","auto","No","9772","0","545653","1080","556505","0.16"
"2025-09-15T22:00:42.314Z","Included","auto","No","2337","0","324217","793","327347","0.09"
"2025-09-15T22:00:34.622Z","Errored, Not Charged","auto","No","942","0","106259","436","107637","0.03"
"2025-09-15T22:00:18.014Z","Errored, Not Charged","auto","No","1688","0","210044","861","212593","0.06"
"2025-09-15T21:59:35.991Z","Errored, Not Charged","auto","No","2523","0","617914","1713","622150","0.17"
"2025-09-15T21:59:05.126Z","Errored, Not Charged","auto","No","2502","0","503961","1548","508011","0.14"
"2025-09-15T21:58:20.664Z","Included","auto","No","6236","0","678120","1959","686315","0.19"
"2025-09-15T21:57:25.087Z","Included","auto","No","2464","0","753150","922","756536","0.20"
"2025-09-15T21:57:03.258Z","Errored, Not Charged","auto","No","85796","38097","7060","1900","132853","0.17"
"2025-09-15T20:23:56.492Z","Included","auto","No","62583","0","4780145","18572","4861300","1.38"
"2025-09-15T20:22:20.614Z","Included","auto","No","115","0","58973","223","59311","0.02"
"2025-09-15T20:21:59.321Z","Errored, Not Charged","auto","No","8003","0","50654","271","58928","0.02"
"2025-09-15T20:21:32.765Z","Included","auto","No","43599","0","158486","997","203082","0.10"
"2025-09-15T20:03:47.946Z","Included","auto","No","23717","0","7060","416","31193","0.03"
"2025-09-15T19:21:15.677Z","Errored, Not Charged","auto","No","0","0","0","0","0","0.00"
"2025-09-15T16:58:10.971Z","Errored, Not Charged","auto","No","0","0","0","0","0","0.00"
"2025-09-15T04:58:41.105Z","Errored, Not Charged","auto","No","0","0","0","0","0","0.00"
"2025-09-15T03:42:07.683Z","Errored, Not Charged","auto","No","0","0","0","0","0","0.00"
"2025-09-15T03:23:48.707Z","Errored, Not Charged","auto","No","0","0","0","0","0","0.00"
"2025-09-15T02:43:48.194Z","Errored, Not Charged","auto","No","0","0","0","0","0","0.00"
"2025-09-15T00:28:36.218Z","Errored, Not Charged","auto","No","0","0","0","0","0","0.00"
"2025-09-15T00:24:05.130Z","Errored, Not Charged","auto","No","0","0","0","0","0","0.00"
"2025-09-15T00:23:47.905Z","Errored, Not Charged","auto","No","0","0","0","0","0","0.00"
"2025-09-15T00:17:43.278Z","Included","auto","No","2719","0","222549","1012","226280","0.06"
"2025-09-15T00:16:56.340Z","Included","auto","No","2023","0","160089","420","162532","0.04"
"2025-09-15T00:16:23.610Z","Included","auto","No","2157","0","153961","380","156498","0.04"
"2025-09-15T00:16:08.180Z","Included","auto","No","286","0","50731","294","51311","0.01"
"2025-09-15T00:15:41.936Z","Errored, Not Charged","auto","No","1526","0","349877","547","351950","0.09"
"2025-09-15T00:13:46.654Z","Included","auto","No","4449","0","236172","703","241324","0.07"
"2025-09-15T00:13:04.656Z","Included","auto","No","911","0","180080","636","181627","0.05"
"2025-09-15T00:12:36.660Z","Errored, Not Charged","auto","No","1905","0","393701","646","396252","0.10"
"2025-09-15T00:10:42.702Z","Included","auto","No","1179","0","252596","803","254578","0.07"
"2025-09-15T00:10:05.073Z","Included","auto","No","1254","0","204576","621","206451","0.05"
"2025-09-15T00:09:40.772Z","Included","auto","No","10110","0","30195","352","40657","0.02"
"2025-09-15T00:09:21.039Z","Included","auto","No","277","0","39662","277","40216","0.01"
"2025-09-15T00:08:36.238Z","Errored, Not Charged","auto","No","0","0","0","0","0","0.00"
"2025-09-15T00:08:31.037Z","Errored, Not Charged","auto","No","4790","0","408598","1629","415017","0.11"
"2025-09-15T00:07:41.032Z","Errored, Not Charged","auto","No","4704","0","518859","1516","525079","0.14"
"2025-09-15T00:07:17.059Z","Errored, Not Charged","auto","No","2383","0","259766","681","262830","0.07"
"2025-09-15T00:06:12.300Z","Included","auto","No","1253","0","134850","434","136537","0.04"
"2025-09-15T00:06:01.688Z","Included","auto","No","580","0","25843","298","26721","0.01"
"2025-09-15T00:05:32.832Z","Included","auto","No","576","0","25268","479","26323","0.01"
"2025-09-15T00:05:07.395Z","Errored, Not Charged","auto","No","0","0","0","0","0","0.00"
"2025-09-15T00:04:50.674Z","Included","auto","No","702","0","24567","477","25746","0.01"
"2025-09-15T00:04:08.132Z","Included","auto","No","736","0","48130","770","49636","0.02"
"2025-09-15T00:02:48.389Z","Included","auto","No","17109","0","6725","391","24225","0.02"
"2025-09-14T23:50:13.104Z","Errored, Not Charged","auto","No","0","0","0","0","0","0.00"
"2025-09-14T23:46:35.725Z","Errored, Not Charged","auto","No","0","0","0","0","0","0.00"
"2025-09-14T23:30:44.593Z","Errored, Not Charged","auto","No","0","0","0","0","0","0.00"
"2025-09-14T23:30:28.580Z","Included","auto","No","0","0","0","0","0","0.00"
"2025-09-14T23:28:11.208Z","Aborted, Not Charged","auto","No","0","0","0","0","0","0.00"
"2025-09-14T23:24:10.746Z","Errored, Not Charged","auto","No","0","0","0","0","0","0.00"
"2025-09-14T23:20:09.459Z","Errored, Not Charged","auto","No","0","0","0","0","0","0.00"
"2025-09-14T23:16:55.824Z","Errored, Not Charged","auto","No","0","0","0","0","0","0.00"
"2025-09-14T22:59:00.819Z","Errored, Not Charged","auto","No","0","0","0","0","0","0.00"
"2025-09-14T22:56:13.799Z","Errored, Not Charged","auto","No","0","0","0","0","0","0.00"
"2025-09-14T22:45:11.418Z","Errored, Not Charged","auto","No","0","0","0","0","0","0.00"
"2025-09-14T22:39:26.071Z","Errored, Not Charged","auto","No","0","0","0","0","0","0.00"
"2025-09-14T22:33:23.129Z","Errored, Not Charged","auto","No","0","0","0","0","0","0.00"
"2025-09-14T22:29:11.920Z","Errored, Not Charged","auto","No","0","0","0","0","0","0.00"
"2025-09-14T22:16:39.341Z","Included","auto","No","319343","0","2032600","8860","2360803","0.86"
"2025-09-14T22:15:59.717Z","Included","auto","No","34511","0","364435","434","399380","0.13"
"2025-09-14T22:12:47.144Z","Errored, Not Charged","auto","No","0","0","0","0","0","0.00"
"2025-09-14T22:09:45.207Z","Errored, Not Charged","auto","No","0","0","0","0","0","0.00"
"2025-09-14T22:05:39.553Z","Included","auto","No","4763","0","464449","2125","471337","0.13"
"2025-09-14T22:04:54.354Z","Errored, Not Charged","auto","No","115","0","55495","123","55733","0.01"
"2025-09-14T22:04:21.613Z","Errored, Not Charged","auto","No","651","0","54386","132","55169","0.01"
"2025-09-14T22:01:18.580Z","Included","auto","No","7067","0","592557","1887","601511","0.16"
"2025-09-14T21:59:00.814Z","Included","auto","No","14623","72001","79838","17421","183883","0.11"
"2025-09-14T21:56:23.133Z","Included","auto","No","4258","0","1017656","1607","1023521","0.27"
"2025-09-14T21:55:10.738Z","Included","auto","No","2228","0","547775","611","550614","0.14"
"2025-09-14T21:52:27.070Z","Included","auto","No","6425","0","1584738","958","1592121","0.41"
"2025-09-14T21:51:57.335Z","Included","auto","No","426","0","204109","133","204668","0.05"
"2025-09-14T21:47:19.183Z","Errored, Not Charged","auto","No","7199","0","1268461","3784","1279444","0.34"
"2025-09-14T21:45:46.315Z","Included","auto","No","1900","0","559887","455","562242","0.14"
"2025-09-14T21:43:59.689Z","Included","auto","No","1754","0","458573","631","460958","0.12"
"2025-09-14T21:42:49.363Z","Included","auto","No","3062","0","265459","581","269102","0.07"
"2025-09-14T21:31:33.438Z","Included","auto","No","13196","4302","1059126","10518","1087142","0.34"
"2025-09-14T21:27:10.589Z","Included","auto","No","11041","0","1075566","1320","1087927","0.29"
"2025-09-14T21:23:56.256Z","Included","auto","No","5880","0","599875","1635","607390","0.16"
"2025-09-14T21:22:51.313Z","Included","auto","No","56450","0","132381","912","189743","0.09"
"2025-09-14T21:17:40.612Z","Included","auto","No","3607","0","413298","1071","417976","0.11"
"2025-09-14T21:16:22.703Z","Errored, Not Charged","auto","No","406","0","171146","120","171672","0.04"
"2025-09-14T21:15:33.365Z","Errored, Not Charged","auto","No","115","0","56196","72","56383","0.01"
"2025-09-14T21:14:35.039Z","Errored, Not Charged","auto","No","663","0","54558","508","55729","0.02"
"2025-09-14T21:12:19.757Z","Errored, Not Charged","auto","No","21493","534","84085","15947","122059","0.09"
"2025-09-14T21:10:41.450Z","Errored, Not Charged","auto","No","0","0","0","0","0","0.00"
"2025-09-14T21:08:40.758Z","Errored, Not Charged","auto","No","0","0","0","0","0","0.00"
"2025-09-14T20:59:28.647Z","Included","auto","No","36329","0","2051688","7031","2095048","0.58"
"2025-09-14T20:58:29.268Z","Included","auto","No","641","0","107788","165","108594","0.03"
"2025-09-14T20:57:11.859Z","Errored, Not Charged","auto","No","665","0","212013","938","213616","0.06"
"2025-09-14T20:54:57.588Z","Errored, Not Charged","auto","No","1407","0","309427","2536","313370","0.09"
"2025-09-14T20:54:13.975Z","Errored, Not Charged","auto","No","132","1717","102011","578","104438","0.04"
"2025-09-14T20:52:55.365Z","Errored, Not Charged","auto","No","1982","0","301987","358","304327","0.08"
"2025-09-14T20:49:30.616Z","Errored, Not Charged","auto","No","1779","0","188330","5071","195180","0.07"
"2025-09-14T20:47:59.215Z","Errored, Not Charged","auto","No","1024","0","278077","332","279433","0.07"
"2025-09-14T20:41:11.450Z","Errored, Not Charged","auto","No","9129","0","1742851","2972","1754952","0.46"
"2025-09-14T20:40:27.046Z","Errored, Not Charged","auto","No","37920","0","44743","260","82923","0.05"
"2025-09-14T20:38:30.334Z","Included","auto","No","1521","0","244962","259","246742","0.06"
"2025-09-14T20:24:24.052Z","Included","auto","No","18306","0","1887410","11555","1917271","0.54"
"2025-09-14T20:19:53.603Z","Errored, Not Charged","auto","No","53857","0","123199","5213","182269","0.11"
"2025-09-14T20:18:48.457Z","Included","auto","No","1676","0","111094","1494","114264","0.04"
"2025-09-14T20:18:09.642Z","Included","auto","No","927","0","274326","244","275497","0.07"
"2025-09-14T20:11:26.614Z","Included","auto","No","9830","0","436009","7949","453788","0.15"
"2025-09-14T20:09:35.663Z","Errored, Not Charged","auto","No","17609","76791","25362","13305","133067","0.08"
"2025-09-14T20:09:24.612Z","Errored, Not Charged","auto","No","0","0","0","0","0","0.00"
"2025-09-14T20:08:26.100Z","Errored, Not Charged","auto","No","0","0","0","0","0","0.00"
"2025-09-14T20:06:48.145Z","Errored, Not Charged","auto","No","0","0","0","0","0","0.00"
"2025-09-14T20:05:44.651Z","Errored, Not Charged","auto","No","105","0","113733","2842","116680","0.04"
"2025-09-14T20:05:26.649Z","Errored, Not Charged","auto","No","109","0","113460","89","113658","0.03"
"2025-09-14T19:54:26.135Z","Included","auto","No","43758","17696","2897477","25331","2984262","0.98"
"2025-09-14T19:53:41.259Z","Included","auto","No","7114","0","131876","418","139408","0.04"
"2025-09-14T19:52:57.010Z","Included","auto","No","990","0","204295","526","205811","0.05"
"2025-09-14T19:50:17.061Z","Included","auto","No","4937","0","126124","4177","135238","0.05"
"2025-09-14T19:46:24.120Z","Errored, Not Charged","auto","No","16651","10040","685068","11061","722820","0.31"
"2025-09-14T19:44:48.860Z","Included","auto","No","693","0","43310","284","44287","0.01"
"2025-09-14T19:44:20.297Z","Included","auto","No","242","0","43069","81","43392","0.01"
"2025-09-14T19:43:46.434Z","Included","auto","No","17709","0","153448","329","171486","0.06"
"2025-09-14T19:40:37.999Z","Included","auto","No","34777","689834","264102","13093","1001806","0.25"
"2025-09-14T19:37:45.094Z","Included","auto","No","673","0","154283","362","155318","0.04"
"2025-09-14T19:35:53.954Z","Errored, Not Charged","auto","No","7616","78250","30586","11713","128165","0.07"
"2025-09-14T19:35:40.730Z","Errored, Not Charged","auto","No","164","0","112230","35","112429","0.03"
"2025-09-14T19:34:49.682Z","Errored, Not Charged","auto","No","1007","0","669508","234","670749","0.17"
"2025-09-14T19:34:13.514Z","Included","auto","No","748","0","110359","150","111257","0.03"
"2025-09-14T19:29:14.080Z","Included","auto","No","214","0","110146","128","110488","0.03"
"2025-09-14T19:28:38.502Z","Included","auto","No","1794","0","216973","1009","219776","0.06"
"2025-09-14T19:27:38.200Z","Included","auto","No","1624","0","213810","729","216163","0.06"
"2025-09-14T19:26:25.816Z","Included","auto","No","2132","0","210104","1344","213580","0.06"
"2025-09-14T19:24:51.218Z","Included","auto","No","678","0","103925","214","104817","0.03"
"2025-09-14T19:21:58.362Z","Included","auto","No","7172","0","498535","3470","509177","0.15"
"2025-09-14T19:21:04.068Z","Included","auto","No","2016","0","190219","755","192990","0.05"
"2025-09-14T19:19:50.181Z","Included","auto","No","103693","0","84297","924","188914","0.13"
"2025-09-14T19:11:54.147Z","Included","auto","No","4656","0","537483","1863","544002","0.15"
"2025-09-14T19:11:09.643Z","Included","auto","No","2298","0","171780","817","174895","0.05"
"2025-09-14T19:10:10.073Z","Errored, Not Charged","auto","No","1267","0","167241","770","169278","0.05"
"2025-09-14T19:09:44.663Z","Errored, Not Charged","auto","No","102","0","81949","558","82609","0.02"
"2025-09-14T19:09:23.953Z","Errored, Not Charged","auto","No","652","1519","80301","976","83448","0.03"
"2025-09-14T19:07:58.550Z","Errored, Not Charged","auto","No","1091","0","155166","1056","157313","0.04"
"2025-09-14T19:06:43.307Z","Errored, Not Charged","auto","No","16609","4146","280764","3483","305002","0.13"
"2025-09-14T19:05:11.226Z","Included","auto","No","4654","3948","343809","3100","355511","0.13"
"2025-09-14T19:04:01.720Z","Errored, Not Charged","auto","No","2140","3663","256258","2760","264821","0.10"
"2025-09-14T19:03:24.030Z","Errored, Not Charged","auto","No","2125","3477","184349","1905","191856","0.07"
"2025-09-14T19:03:02.008Z","Errored, Not Charged","auto","No","644","0","59087","502","60233","0.02"
"2025-09-14T19:01:18.456Z","Errored, Not Charged","auto","No","20036","8072","436704","3519","468331","0.18"
"2025-09-14T18:55:38.096Z","Included","auto","No","957","967","107793","728","110445","0.04"
"2025-09-14T18:55:16.757Z","Included","auto","No","1299","907","105677","665","108548","0.04"
"2025-09-14T18:54:30.767Z","Errored, Not Charged","auto","No","669","0","50710","552","51931","0.02"
"2025-09-14T18:53:57.632Z","Included","auto","No","1708","0","98636","547","100891","0.03"
"2025-09-14T18:53:24.376Z","Errored, Not Charged","auto","No","1296","2241","143735","878","148150","0.05"
"2025-09-14T18:52:23.532Z","Errored, Not Charged","auto","No","2945","1258","177495","1807","183505","0.06"
"2025-09-14T18:51:54.486Z","Included","auto","No","1691","1244","126597","1027","130559","0.05"
"2025-09-14T18:48:51.666Z","Errored, Not Charged","auto","No","31009","9605","168509","2441","211564","0.12"
"2025-09-14T18:45:41.724Z","Errored, Not Charged","auto","No","7055","26820","1699807","5952","1739634","0.55"
"2025-09-14T18:40:40.412Z","Included","auto","No","13124","12472","1125510","9150","1160256","0.40"
"2025-09-14T18:35:29.420Z","Included","auto","No","16303","18421","1313396","14313","1362433","0.53"
"2025-09-14T18:28:37.791Z","Included","auto","No","14497","5555","1016123","9891","1046066","0.36"
"2025-09-14T18:24:58.680Z","Errored, Not Charged","auto","No","12856","3744","480125","7773","504498","0.19"
"2025-09-14T18:23:09.582Z","Included","auto","No","3126","0","101603","1037","105766","0.03"
"2025-09-14T18:22:06.885Z","Included","auto","No","912","0","100964","215","102091","0.03"
"2025-09-14T18:21:18.021Z","Errored, Not Charged","auto","No","981","0","97823","656","99460","0.03"
"2025-09-14T18:20:34.640Z","Included","auto","No","106","0","48497","110","48713","0.01"
"2025-09-14T18:19:55.134Z","Errored, Not Charged","auto","No","40766","0","7060","600","48426","0.04"
"2025-09-14T18:19:33.254Z","Included","auto","No","0","0","0","0","0","0.00"
"2025-09-14T18:17:51.575Z","Included","auto","No","117","0","47392","889","48398","0.02"
"2025-09-14T18:17:27.801Z","Included","auto","No","680","243","93531","600","95054","0.03"
"2025-09-14T18:16:54.803Z","Included","auto","No","1774","394","136742","1080","139990","0.05"
"2025-09-14T18:11:31.831Z","Errored, Not Charged","auto","No","22157","17200","1124305","10291","1173953","0.45"
"2025-09-14T18:09:37.533Z","Errored, Not Charged","auto","No","126","0","109098","3220","112444","0.04"
"2025-09-14T18:08:54.437Z","Errored, Not Charged","auto","No","1181","5022","321492","1976","329671","0.11"
"2025-09-14T18:08:14.936Z","Errored, Not Charged","auto","No","1479","4989","316012","1647","324127","0.11"
"2025-09-14T18:06:43.517Z","Included","auto","No","5282","8135","611798","4108","629323","0.22"
"2025-09-14T18:01:03.719Z","Included","auto","No","16483","0","807909","2825","827217","0.23"
"2025-09-14T17:58:51.190Z","Included","auto","No","953","0","165294","325","166572","0.04"
"2025-09-14T17:58:01.155Z","Included","auto","No","708","0","163629","256","164593","0.04"
"2025-09-14T17:47:05.974Z","Included","auto","No","17103","0","794715","3198","815016","0.23"
"2025-09-14T17:30:17.366Z","Included","auto","No","6877","0","423579","5764","436220","0.14"
"2025-09-14T17:28:55.072Z","Included","auto","No","33891","0","23836","90","57817","0.04"
"2025-09-14T17:18:15.792Z","Included","auto","No","306517","978610","4802280","31870","6119277","1.77"
"2025-09-14T17:17:41.392Z","Included","auto","No","51108","0","118642","2761","172511","0.09"
"2025-09-14T17:14:47.126Z","Included","auto","No","47071","0","59456","1708","108235","0.07"
"2025-09-14T16:22:53.906Z","Included","auto","No","1136","0","101025","597","102758","0.03"
"2025-09-14T16:22:31.137Z","Included","auto","No","43406","0","57119","106","100631","0.06"
"2025-09-14T06:05:01.748Z","Included","auto","No","32491","81162","373341","24180","511174","0.23"
"2025-09-14T06:01:44.902Z","Included","auto","No","6266","0","220426","6129","232821","0.09"
"2025-09-14T06:01:12.540Z","Included","auto","No","2134","0","326145","243","328522","0.08"
"2025-09-14T06:00:16.660Z","Included","auto","No","836","0","107189","248","108273","0.03"
"2025-09-14T05:58:57.873Z","Included","auto","No","1743","0","317257","368","319368","0.08"
"2025-09-14T05:58:05.041Z","Included","auto","No","580","0","104870","225","105675","0.03"
"2025-09-14T05:52:02.082Z","Included","auto","No","15888","0","975831","5837","997556","0.28"
"2025-09-14T05:42:16.780Z","Included","auto","No","2383","0","366690","430","369503","0.10"
"2025-09-14T05:41:35.228Z","Errored, Not Charged","auto","No","1962","0","178672","257","180891","0.05"
"2025-09-14T05:41:02.422Z","Included","auto","No","81934","0","95880","94","177908","0.11"
"2025-09-14T05:13:41.674Z","Included","auto","No","17890","0","52767","78","70735","0.03"
"2025-09-14T05:12:04.035Z","Errored, Not Charged","auto","No","1014","0","170709","250","171973","0.04"
"2025-09-14T05:10:36.893Z","Included","auto","No","3637","0","216491","1534","221662","0.06"
"2025-09-14T05:08:12.906Z","Errored, Not Charged","auto","No","19833","0","85327","388","105548","0.04"
"2025-09-14T05:03:15.529Z","Included","auto","No","16398","0","2003740","5438","2025576","0.54"
"2025-09-14T04:56:29.203Z","Errored, Not Charged","auto","No","11127","0","1399990","10822","1421939","0.40"
"2025-09-14T04:53:35.287Z","Included","auto","No","404","0","86910","347","87661","0.02"
"2025-09-14T04:52:29.346Z","Included","auto","No","1511","0","171395","357","173263","0.05"
"2025-09-14T04:50:44.592Z","Included","auto","No","518","0","84884","476","85878","0.02"
"2025-09-14T04:49:20.937Z","Included","auto","No","653","0","168930","485","170068","0.04"
"2025-09-14T04:47:19.107Z","Included","auto","No","524","0","83710","357","84591","0.02"
"2025-09-14T04:46:19.482Z","Included","auto","No","1762","0","81949","379","84090","0.02"
"2025-09-14T04:45:53.535Z","Included","auto","No","0","0","0","0","0","0.00"
"2025-09-14T04:43:34.790Z","Included","auto","No","134","0","83298","4584","88016","0.04"
"2025-09-14T04:42:56.597Z","Errored, Not Charged","auto","No","874","0","164572","120","165566","0.04"
"2025-09-14T04:40:30.468Z","Included","auto","No","8881","0","228245","4135","241261","0.08"
"2025-09-14T04:38:24.834Z","Included","auto","No","3720","0","147253","2928","153901","0.05"
"2025-09-14T04:36:56.594Z","Errored, Not Charged","auto","No","412","0","70684","1916","73012","0.03"
"2025-09-14T04:33:51.915Z","Included","auto","No","8523","0","395721","5333","409577","0.13"
"2025-09-14T04:33:30.335Z","Errored, Not Charged","auto","No","0","0","0","0","0","0.00"
"2025-09-14T03:55:19.373Z","Included","auto","No","70798","771928","173834","30449","1047009","0.34"
"2025-09-14T03:54:15.465Z","Included","auto","No","0","0","0","0","0","0.00"
"2025-09-14T03:42:34.604Z","Included","auto","No","28523","0","1111660","7812","1147995","0.34"
"2025-09-14T03:40:15.460Z","Errored, Not Charged","auto","No","10056","0","30579","220","40855","0.02"
"2025-09-14T03:39:18.828Z","Included","auto","No","1389","0","223829","1227","226445","0.06"
"2025-09-14T03:39:00.527Z","Errored, Not Charged","auto","No","273","0","111268","249","111790","0.03"
"2025-09-14T03:37:57.390Z","Included","auto","No","488","0","110781","85","111354","0.03"
"2025-09-14T03:37:39.289Z","Included","auto","No","1267","0","109515","334","111116","0.03"
"2025-09-14T03:36:29.767Z","Included","auto","No","685","0","109515","422","110622","0.03"
"2025-09-14T03:35:34.040Z","Included","auto","No","1360","0","216747","1036","219143","0.06"
"2025-09-14T03:35:16.611Z","Included","auto","No","1669","0","106489","282","108440","0.03"
"2025-09-14T03:34:50.092Z","Included","auto","No","584","0","107221","200","108005","0.03"
"2025-09-14T03:33:43.299Z","Included","auto","No","734","0","213562","63","214359","0.05"
"2025-09-14T03:32:19.406Z","Included","auto","No","99432","0","217491","1243","318166","0.16"
"2025-09-14T02:49:58.267Z","Included","auto","No","2705","0","412746","1651","417102","0.11"
"2025-09-14T02:49:27.166Z","Included","auto","No","1011","0","203222","125","204358","0.05"
"2025-09-14T02:48:17.659Z","Included","auto","No","1026","0","200626","948","202600","0.05"
"2025-09-14T02:47:45.413Z","Included","auto","No","33624","0","166713","118","200455","0.08"
"2025-09-14T02:45:49.271Z","Included","auto","No","402","0","199014","299","199715","0.05"
"2025-09-14T02:45:19.663Z","Included","auto","No","672","1963","197668","636","200939","0.06"
"2025-09-14T02:44:13.901Z","Included","auto","No","1677","1864","391702","894","396137","0.11"
"2025-09-14T02:43:21.789Z","Included","auto","No","21191","1765","228664","989","252609","0.09"
"2025-09-14T02:42:59.443Z","Included","auto","No","1113","1722","150247","459","153541","0.05"
"2025-09-14T02:42:30.539Z","Included","auto","No","530","1662","148672","398","151262","0.04"
"2025-09-14T02:42:12.414Z","Included","auto","No","374","0","147925","351","148650","0.04"
"2025-09-14T02:41:00.507Z","Errored, Not Charged","auto","No","2554","0","214260","1180","217994","0.06"
"2025-09-14T02:39:40.679Z","Included","auto","No","1883","0","138025","1849","141757","0.04"
"2025-09-14T02:38:35.135Z","Included","auto","No","2315","0","336837","854","340006","0.09"
"2025-09-14T02:37:56.515Z","Included","auto","No","15093","0","182440","236","197769","0.06"
"2025-09-14T02:33:50.341Z","Included","auto","No","3993","0","189560","489","194042","0.05"
"2025-09-14T02:32:31.595Z","Included","auto","No","57200","0","256978","538","314716","0.12"
"2025-09-14T02:31:55.881Z","Included","auto","No","923","0","120784","164","121871","0.03"
"2025-09-14T02:31:04.179Z","Included","auto","No","1997","0","178385","312","180694","0.05"
"2025-09-14T02:30:38.824Z","Included","auto","No","292","0","116201","139","116632","0.03"
"2025-09-14T02:29:23.051Z","Included","auto","No","3217","667","282893","514","287291","0.08"
"2025-09-14T02:28:30.355Z","Included","auto","No","1210","0","215925","460","217595","0.06"
"2025-09-14T02:27:33.340Z","Included","auto","No","2085","0","208970","552","211607","0.06"
"2025-09-14T02:27:11.164Z","Included","auto","No","910","0","101503","301","102714","0.03"
"2025-09-14T02:21:45.074Z","Errored, Not Charged","auto","No","45743","1765","353631","1429","402568","0.15"
"2025-09-14T02:04:47.491Z","Included","auto","No","113882","0","404092","362","518336","0.22"
"2025-09-14T02:02:24.793Z","Included","auto","No","913","0","194243","32","195188","0.05"
"2025-09-14T02:02:06.690Z","Included","auto","No","306","0","193636","99","194041","0.05"
"2025-09-14T02:01:44.415Z","Included","auto","No","673","1462","192332","484","194951","0.06"
"2025-09-14T02:00:28.346Z","Included","auto","No","6242","0","185402","178","191822","0.05"
"2025-09-14T01:59:34.262Z","Errored, Not Charged","auto","No","0","0","0","0","0","0.00"
"2025-09-14T01:57:25.908Z","Included","auto","No","3083","0","183435","232","186750","0.05"
"2025-09-14T01:57:02.015Z","Included","auto","No","1799","0","179808","149","181756","0.05"
"2025-09-14T01:56:45.719Z","Included","auto","No","9100","0","169591","291","178982","0.05"
"2025-09-14T01:56:04.500Z","Included","auto","No","81412","0","94816","445","176673","0.11"
"2025-09-14T01:48:48.514Z","Errored, Not Charged","auto","No","4565","0","905473","2288","912326","0.24"
"2025-09-14T01:47:21.222Z","Errored, Not Charged","auto","No","23361","0","450912","1634","475907","0.14"
"2025-09-14T01:42:13.720Z","Included","auto","No","1035","0","153863","114","155012","0.04"
"2025-09-14T01:40:46.287Z","Included","auto","No","621","0","152629","130","153380","0.04"
"2025-09-14T01:39:56.453Z","Included","auto","No","1159","0","150311","160","151630","0.04"
"2025-09-14T01:39:18.738Z","Included","auto","No","13085","0","199047","246","212378","0.06"
"2025-09-14T01:38:46.633Z","Included","auto","No","4375","0","119438","188","124001","0.03"
"2025-09-14T01:38:27.094Z","Errored, Not Charged","auto","No","781","290","56362","450","57883","0.02"
"2025-09-14T01:35:21.124Z","Errored, Not Charged","auto","No","31002","0","75829","423","107254","0.05"
"2025-09-14T01:33:41.602Z","Errored, Not Charged","auto","No","0","0","0","0","0","0.00"
"2025-09-14T01:33:17.273Z","Included","auto","No","938","0","231392","713","233043","0.06"
"2025-09-14T01:32:44.646Z","Errored, Not Charged","auto","No","1186","0","229912","104","231202","0.06"
"2025-09-14T01:32:07.698Z","Included","auto","No","1062","0","343327","341","344730","0.09"
"2025-09-14T01:31:02.901Z","Included","auto","No","1906","10020","565392","1794","579112","0.18"
"2025-09-14T01:28:29.535Z","Errored, Not Charged","auto","No","10134","11390","1364129","3221","1388874","0.40"
"2025-09-14T01:28:18.515Z","Included","auto","No","797","0","101155","167","102119","0.03"
"2025-09-14T01:27:57.306Z","Included","auto","No","319","0","101310","168","101797","0.03"
"2025-09-14T01:27:43.110Z","Included","auto","No","156","0","101155","169","101480","0.03"
"2025-09-14T01:27:21.285Z","Included","auto","No","1927","0","198797","990","201714","0.06"
"2025-09-14T01:26:47.868Z","Included","auto","No","4060","0","192860","984","197904","0.06"
"2025-09-14T01:25:33.875Z","Included","auto","No","822","0","193943","151","194916","0.05"
"2025-09-14T01:25:05.310Z","Included","auto","No","1462","0","190496","1333","193291","0.05"
"2025-09-14T01:24:44.010Z","Errored, Not Charged","auto","No","1988","0","91626","826","94440","0.03"
"2025-09-14T01:24:01.764Z","Included","auto","No","1524","0","183936","1073","186533","0.05"
"2025-09-14T01:23:39.550Z","Included","auto","No","6941","0","175722","566","183229","0.05"
"2025-09-14T01:23:06.785Z","Included","auto","No","501","0","90217","159","90877","0.02"
"2025-09-14T01:22:50.521Z","Included","auto","No","2863","0","87355","354","90572","0.03"
"2025-09-14T01:21:35.640Z","Errored, Not Charged","auto","No","2329","4776","437972","1887","446964","0.14"
"2025-09-14T01:21:03.726Z","Included","auto","No","927","1542","171605","754","174828","0.05"
"2025-09-14T01:20:30.777Z","Errored, Not Charged","auto","No","582","3020","169530","821","173953","0.06"
"2025-09-14T01:20:15.234Z","Included","auto","No","4120","0","165087","131","169338","0.05"
"2025-09-14T01:15:47.465Z","Included","auto","No","6694","0","151463","3188","161345","0.06"
"2025-09-14T01:14:53.713Z","Included","auto","No","1827","2502","222704","1559","228592","0.08"
"2025-09-14T01:14:51.209Z","Included","auto","No","5878","5004","451257","4963","467102","0.16"
"2025-09-14T01:14:37.712Z","Included","auto","No","265","0","73116","177","73558","0.02"
"2025-09-14T01:13:43.469Z","Errored, Not Charged","auto","No","0","0","0","0","0","0.00"
"2025-09-14T01:13:27.647Z","Included","auto","No","490","0","72122","350","72962","0.02"
"2025-09-14T01:09:37.660Z","Included","auto","No","326","0","71797","116","72239","0.02"
"2025-09-14T01:09:24.934Z","Included","auto","No","14639","0","57159","173","71971","0.03"
"2025-09-14T01:08:02.510Z","Included","auto","No","0","0","0","0","0","0.00"
"2025-09-14T01:06:50.362Z","Included","auto","No","1380","0","139226","331","140937","0.04"
"2025-09-14T01:06:12.056Z","Errored, Not Charged","auto","No","567","0","67946","415","68928","0.02"
"2025-09-14T01:05:32.903Z","Errored, Not Charged","auto","No","139","0","66484","633","67256","0.02"
"2025-09-14T01:05:15.806Z","Included","auto","No","2626","0","128222","68","130916","0.03"
"2025-09-14T01:04:56.626Z","Included","auto","No","149","0","63712","353","64214","0.02"
"2025-09-14T01:03:35.508Z","Errored, Not Charged","auto","No","2972","0","245663","1820","250455","0.07"
"2025-09-14T01:02:58.458Z","Included","auto","No","35213","0","84190","1741","121144","0.06"
"2025-09-14T00:59:43.646Z","Included","auto","No","62564","767271","49342","23527","902704","0.27"
"2025-09-14T00:55:13.213Z","Included","auto","No","3429","0","416170","858","420457","0.11"
"2025-09-14T00:53:57.272Z","Errored, Not Charged","auto","No","139","0","78070","4062","82271","0.04"
"2025-09-14T00:52:09.538Z","Errored, Not Charged","auto","No","70588","0","306831","2510","379929","0.16"
"2025-09-14T00:51:22.854Z","Errored, Not Charged","auto","No","671","0","69805","2303","72779","0.03"
"2025-09-14T00:50:42.489Z","Included","auto","No","2448","0","135430","1694","139572","0.04"
"2025-09-14T00:48:04.855Z","Errored, Not Charged","auto","No","38510","0","94819","1351","134680","0.07"
"2025-09-14T00:47:37.468Z","Errored, Not Charged","auto","No","99","0","106141","51","106291","0.03"
"2025-09-14T00:47:05.131Z","Errored, Not Charged","auto","No","23011","0","81703","1361","106075","0.05"
"2025-09-14T00:46:07.122Z","Included","auto","No","20889","0","252810","653","274352","0.09"
"2025-09-14T00:44:57.791Z","Errored, Not Charged","auto","No","563","0","81703","81","82347","0.02"
"2025-09-14T00:44:04.251Z","Included","auto","No","2941","2220","320712","1618","327491","0.10"
"2025-09-14T00:40:34.791Z","Included","auto","No","1293","0","314862","642","316797","0.08"
"2025-09-14T00:30:22.435Z","Errored, Not Charged","auto","No","83048","7700","1902206","5318","1998272","0.61"
"2025-09-14T00:28:48.729Z","Included","auto","No","1808","0","170422","495","172725","0.05"
"2025-09-14T00:26:23.551Z","Included","auto","No","904","0","169667","458","171029","0.05"
"2025-09-14T00:24:01.713Z","Errored, Not Charged","auto","No","18504","0","223637","3275","245416","0.09"
"2025-09-14T00:09:01.479Z","Included","auto","No","8374","0","819681","1745","829800","0.22"
"2025-09-14T00:08:41.830Z","Included","auto","No","1676","0","139193","253","141122","0.04"
"2025-09-14T00:07:56.697Z","Included","auto","No","478","0","277024","146","277648","0.07"
"2025-09-14T00:07:24.755Z","Included","auto","No","638","0","137359","84","138081","0.04"
"2025-09-14T00:06:50.360Z","Included","auto","No","865","0","204040","129","205034","0.05"
"2025-09-14T00:06:17.206Z","Included","auto","No","390","0","134442","109","134941","0.03"
"2025-09-14T00:04:46.181Z","Included","auto","No","1206","0","398090","301","399597","0.10"
"2025-09-14T00:03:17.340Z","Errored, Not Charged","auto","No","662","0","62686","2550","65898","0.03"
"2025-09-14T00:01:58.234Z","Included","auto","No","461","0","124783","83","125327","0.03"
"2025-09-14T00:01:46.867Z","Included","auto","No","1596","0","60632","229","62457","0.02"
"2025-09-14T00:00:58.828Z","Included","auto","No","937","0","122415","430","123782","0.03"
"2025-09-13T23:59:25.084Z","Included","auto","No","31462","74160","90199","13425","209246","0.11"
"2025-09-13T23:46:10.525Z","Included","auto","No","943","0","210852","400","212195","0.06"
"2025-09-13T23:44:25.959Z","Included","auto","No","878","0","209371","134","210383","0.05"
"2025-09-13T23:41:04.788Z","Included","auto","No","93192","92520","2494992","15261","2695965","0.79"
"2025-09-13T23:38:01.624Z","Included","auto","No","2701","0","2104603","763","2108067","0.53"
"2025-09-13T23:37:32.455Z","Errored, Not Charged","auto","No","85776","0","23836","96","109708","0.09"
"2025-09-13T23:37:04.351Z","Errored, Not Charged","auto","No","102029","0","7060","131","109220","0.10"
"2025-09-13T23:36:10.302Z","Included","auto","No","42674","0","1150086","1436","1194196","0.34"
"2025-09-13T23:35:38.133Z","Included","auto","No","37810","0","85285","100","123195","0.06"
"2025-09-13T23:34:24.844Z","Errored, Not Charged","auto","No","205625","23682","1963437","17447","2210191","0.76"
"2025-09-13T22:55:24.615Z","Included","auto","No","37231","0","23836","257","61324","0.04"
"2025-09-13T22:48:25.099Z","Included","auto","No","260809","0","4034925","10901","4306635","1.31"
"2025-09-13T22:48:02.917Z","Included","auto","No","372","0","95998","251","96621","0.03"
"2025-09-13T22:47:30.827Z","Included","auto","No","367","0","95632","233","96232","0.03"
"2025-09-13T22:47:14.945Z","Included","auto","No","384","0","95249","249","95882","0.03"
"2025-09-13T22:46:29.826Z","Included","auto","No","107","0","95249","139","95495","0.02"
"2025-09-13T22:46:09.845Z","Included","auto","No","632","0","189739","397","190768","0.05"
"2025-09-13T22:45:39.801Z","Included","auto","No","753","0","188021","795","189569","0.05"
"2025-09-13T22:45:25.243Z","Included","auto","No","359","0","93510","185","94054","0.02"
"2025-09-13T22:44:23.282Z","Included","auto","No","24706","0","68805","251","93762","0.04"
"2025-09-13T22:31:11.818Z","Included","auto","No","16600","0","755196","2744","774540","0.22"
"2025-09-13T22:28:53.574Z","Included","auto","No","2202","0","375943","287","378432","0.10"
"2025-09-13T22:27:28.473Z","Included","auto","No","237","0","147906","103","148246","0.04"
"2025-09-13T22:22:47.674Z","Included","auto","No","35181","0","908996","3366","947543","0.28"
"2025-09-13T22:19:34.764Z","Included","auto","No","20661","866035","47820","5236","939752","0.18"
"2025-09-13T22:12:48.585Z","Included","auto","No","5205","0","1136968","1038","1143211","0.29"
"2025-09-13T22:12:32.289Z","Errored, Not Charged","auto","No","131065","0","4921181","4715","5056961","1.38"
"2025-09-13T22:10:25.979Z","Included","auto","No","61752","0","412926","450","475128","0.17"
"2025-09-13T21:43:39.797Z","Included","auto","No","2000","0","374775","1130","377905","0.10"
"2025-09-13T21:41:17.841Z","Included","auto","No","26584","96783","139768","4327","267462","0.09"
"2025-09-13T21:40:09.492Z","Included","auto","No","1444","0","224434","362","226240","0.06"
"2025-09-13T21:38:20.720Z","Included","auto","No","88306","0","359072","260","447638","0.18"
"2025-09-13T21:36:56.065Z","Included","auto","No","287992","76018","2229452","11669","2605131","0.90"
"2025-09-13T21:06:11.101Z","Included","auto","No","823","0","221410","234","222467","0.06"
"2025-09-13T21:05:41.286Z","Included","auto","No","157","0","110313","334","110804","0.03"
"2025-09-13T21:01:07.896Z","Included","auto","No","4087","0","866999","1745","872831","0.23"
"2025-09-13T20:58:55.818Z","Included","auto","No","1764","0","524880","748","527392","0.14"
"2025-09-13T20:58:02.954Z","Included","auto","No","1133","0","207324","443","208900","0.05"
"2025-09-13T20:57:28.297Z","Included","auto","No","707","0","206446","556","207709","0.05"
"2025-09-13T20:53:16.836Z","Included","auto","No","2115","0","611670","859","614644","0.16"
"2025-09-13T20:52:40.804Z","Included","auto","No","845","0","200933","283","202061","0.05"
"2025-09-13T20:52:10.918Z","Included","auto","No","504","0","99684","426","100614","0.03"
"2025-09-13T20:51:23.281Z","Included","auto","No","4130","0","191242","741","196113","0.05"
"2025-09-13T20:50:57.613Z","Included","auto","No","3811","0","184132","267","188210","0.05"
"2025-09-13T20:49:32.425Z","Included","auto","No","84688","0","7060","487","92235","0.09"
"2025-09-13T20:49:03.559Z","Included","auto","No","81096","116786","4061943","37886","4297711","1.25"
"2025-09-13T18:52:24.654Z","Included","auto","No","23940","0","520206","1247","545393","0.16"
"2025-09-13T18:28:02.566Z","Included","auto","No","183554","0","8688968","13007","8885529","2.41"
"2025-09-13T18:26:20.499Z","Included","auto","No","13965","93107","69972","14340","191384","0.10"
"2025-09-13T18:24:45.572Z","Errored, Not Charged","auto","No","1185","0","456954","230","458369","0.12"
"2025-09-13T18:19:12.568Z","Included","auto","No","6327","0","740789","1189","748305","0.20"
"2025-09-13T18:16:41.282Z","Included","auto","No","106860","0","1836499","1233","1944592","0.57"
"2025-09-13T18:13:44.431Z","Included","auto","No","2121","0","188833","423","191377","0.05"
"2025-09-13T18:01:11.190Z","Included","auto","No","9396","0","1110493","1803","1121692","0.29"
"2025-09-13T18:00:16.598Z","Included","auto","No","7180","0","249346","458","256984","0.07"
"2025-09-13T17:59:39.789Z","Included","auto","No","38939","0","52846","178","91963","0.05"
"2025-09-13T17:50:09.940Z","Included","auto","No","1398","0","319344","384","321126","0.08"
"2025-09-13T17:50:01.908Z","Errored, Not Charged","auto","No","99","0","63340","85","63524","0.02"
"2025-09-13T17:49:46.211Z","Errored, Not Charged","auto","No","566","0","125489","165","126220","0.03"
"2025-09-13T17:45:13.916Z","Errored, Not Charged","auto","No","37009","0","87027","222","124258","0.06"
"2025-09-13T17:38:27.757Z","Included","auto","No","74412","865950","606514","7064","1553940","0.38"
"2025-09-13T17:30:33.928Z","Errored, Not Charged","auto","No","67261","0","1497363","9362","1573986","0.48"
"2025-09-13T17:30:15.559Z","Included","auto","No","619","0","114191","138","114948","0.03"
"2025-09-13T17:29:12.598Z","Included","auto","No","107136","0","460121","349","567606","0.22"
"2025-09-13T17:21:17.778Z","Included","auto","No","1764","0","86866","480","89110","0.03"
"2025-09-13T17:13:37.060Z","Included","auto","No","2783","0","165301","2565","170649","0.05"
"2025-09-13T17:12:38.133Z","Included","auto","No","1623","0","117747","711","120081","0.03"
"2025-09-13T17:08:13.015Z","Included","auto","No","2688","0","185511","2175","190374","0.06"
"2025-09-13T17:06:03.271Z","Included","auto","No","10699","99713","97004","11322","218738","0.09"
"2025-09-13T17:04:03.696Z","Included","auto","No","288","0","111787","287","112362","0.03"
"2025-09-13T17:01:46.481Z","Included","auto","No","2599","0","219629","1386","223614","0.06"
"2025-09-13T16:59:51.394Z","Included","auto","No","785","0","217319","1163","219267","0.06"
"2025-09-13T16:58:33.441Z","Included","auto","No","84572","16532","23836","4752","129692","0.11"
"2025-09-13T16:57:48.736Z","Included","auto","No","120813","51309","4802125","24627","4998874","1.42"
"2025-09-13T16:57:07.469Z","Included","auto","No","78816","0","92026","1547","172389","0.11"
"2025-09-13T14:04:37.975Z","Included","auto","No","45502","0","2944261","1750","2991513","0.79"
"2025-09-13T14:04:08.828Z","Included","auto","No","183803","0","10259355","8741","10451899","2.78"
"2025-09-13T14:03:25.419Z","Errored, Not Charged","auto","No","100865","0","7060","130","108055","0.10"
"2025-09-13T14:02:40.092Z","Included","auto","No","76455","72845","1681424","21497","1852221","0.59"
"2025-09-13T12:53:35.864Z","Included","auto","No","18785","0","2274262","4441","2297488","0.61"
"2025-09-13T12:50:16.939Z","Included","auto","No","5362","0","193179","5389","203930","0.08"
"2025-09-13T12:49:53.572Z","Included","auto","No","4687","0","371622","1094","377403","0.10"
"2025-09-13T12:42:38.079Z","Included","auto","No","92706","0","1893556","1686","1987948","0.57"
"2025-09-13T12:42:16.728Z","Included","auto","No","1342","0","357960","428","359730","0.09"
"2025-09-13T12:40:00.436Z","Errored, Not Charged","auto","No","16324","0","380224","378","396926","0.11"
"2025-09-13T12:39:04.795Z","Errored, Not Charged","auto","No","39611","0","483318","431","523360","0.16"
"2025-09-13T12:38:40.898Z","Included","auto","No","1329","0","211772","301","213402","0.06"
"2025-09-13T12:38:19.612Z","Included","auto","No","197","0","105595","89","105881","0.03"
"2025-09-13T12:37:54.225Z","Included","auto","No","199","0","105397","88","105684","0.03"
"2025-09-13T12:37:30.947Z","Errored, Not Charged","auto","No","0","0","0","0","0","0.00"
"2025-09-13T12:34:41.206Z","Included","auto","No","98098","0","321544","233","419875","0.18"
"2025-09-13T12:29:26.165Z","Included","auto","No","71909","63577","4930348","7476","5073310","1.34"
"2025-09-13T12:27:42.231Z","Included","auto","No","1898","0","270203","1056","273157","0.07"
"2025-09-13T12:27:31.321Z","Errored, Not Charged","auto","No","365","0","89129","50","89544","0.02"
"2025-09-13T12:27:20.625Z","Included","auto","No","1520","0","87610","223","89353","0.02"
"2025-09-13T12:24:52.000Z","Included","auto","No","1217","0","175360","1193","177770","0.05"
"2025-09-13T12:24:36.101Z","Errored, Not Charged","auto","No","501","0","86830","189","87520","0.02"
"2025-09-13T12:23:21.588Z","Included","auto","No","148","0","86830","182","87160","0.02"
"2025-09-13T12:21:29.432Z","Errored, Not Charged","auto","No","8043","1964","1146935","3198","1160140","0.32"
"2025-09-13T12:19:31.668Z","Included","auto","No","5069","0","1500245","1543","1506857","0.39"
"2025-09-13T12:16:48.116Z","Included","auto","No","3998","0","862712","1315","868025","0.22"
"2025-09-13T12:14:58.800Z","Included","auto","No","7184","0","919856","947","927987","0.24"
"2025-09-13T12:13:40.825Z","Included","auto","No","1300","0","269693","604","271597","0.07"
"2025-09-13T12:12:54.205Z","Included","auto","No","1559","0","353578","760","355897","0.09"
"2025-09-13T12:12:23.374Z","Included","auto","No","1108","0","261278","479","262865","0.07"
"2025-09-13T12:11:10.929Z","Included","auto","No","140","0","77992","174","78306","0.02"
"2025-09-13T12:10:47.191Z","Errored, Not Charged","auto","No","529","0","76439","903","77871","0.02"
"2025-09-13T12:10:45.287Z","Errored, Not Charged","auto","No","2694","0","339588","334","342616","0.09"
"2025-09-13T12:10:06.397Z","Included","auto","No","1089","0","251311","327","252727","0.07"
"2025-09-13T12:09:51.699Z","Errored, Not Charged","auto","No","14595","0","68822","96","83513","0.03"
"2025-09-13T12:08:18.642Z","Included","auto","No","3039","0","568415","1441","572895","0.15"
"2025-09-13T12:07:24.429Z","Errored, Not Charged","auto","No","137","0","75290","1882","77309","0.03"
"2025-09-13T12:06:27.759Z","Included","auto","No","5496","0","354466","1364","361326","0.10"
"2025-09-13T12:06:00.909Z","Included","auto","No","980","0","207180","364","208524","0.05"
"2025-09-13T12:05:36.342Z","Errored, Not Charged","auto","No","1352","0","203356","298","205006","0.05"
"2025-09-13T12:05:14.362Z","Included","auto","No","10934","0","56302","323","67559","0.03"
"2025-09-13T12:03:59.927Z","Included","auto","No","1009","0","198729","475","200213","0.05"
"2025-09-13T12:03:43.696Z","Included","auto","No","114","0","65705","300","66119","0.02"
"2025-09-13T12:02:52.007Z","Included","auto","No","1217","0","129634","520","131371","0.04"
"2025-09-13T11:59:40.752Z","Included","auto","No","16288","0","1506490","3233","1526011","0.41"
"2025-09-13T11:59:00.773Z","Included","auto","No","802","0","59372","1780","61954","0.02"
"2025-09-13T11:57:37.999Z","Included","auto","No","8213","0","1493879","2783","1504875","0.39"
"2025-09-13T11:56:47.440Z","Included","auto","No","32324","0","302667","554","335545","0.11"
"2025-09-13T11:54:23.231Z","Included","auto","No","67231","79551","335770","10967","493519","0.20"
"2025-09-13T11:53:46.615Z","Included","auto","No","1575","0","225136","364","227075","0.06"
"2025-09-13T11:49:12.024Z","Errored, Not Charged","auto","No","30760","0","23836","267","54863","0.04"
"2025-09-13T11:46:18.262Z","Included","auto","No","22617","0","1011380","12248","1046245","0.32"
"2025-09-13T11:43:58.238Z","Included","auto","No","3677","0","439129","3153","445959","0.13"
"2025-09-13T11:42:50.797Z","Included","auto","No","78717","0","7060","253","86030","0.08"
"2025-09-13T09:54:57.109Z","Included","auto","No","335179","116242","7006529","54165","7512115","2.31"
"2025-09-13T09:54:17.699Z","Included","auto","No","1126","0","91989","804","93919","0.03"
"2025-09-13T09:53:58.956Z","Included","auto","No","199","0","45782","13","45994","0.01"
"2025-09-13T09:53:28.858Z","Errored, Not Charged","auto","No","866","0","90036","258","91160","0.02"
"2025-09-13T09:53:15.092Z","Included","auto","No","1530","0","86803","427","88760","0.02"
"2025-09-13T09:52:14.381Z","Included","auto","No","769","0","128299","144","129212","0.03"
"2025-09-13T09:51:06.861Z","Included","auto","No","353","0","42126","108","42587","0.01"
"2025-09-13T09:50:33.448Z","Included","auto","No","35069","0","87291","240","122600","0.06"
"2025-09-13T09:46:32.282Z","Included","auto","No","13342","88365","63929","7698","173334","0.07"
"2025-09-13T09:45:49.691Z","Errored, Not Charged","auto","No","4867","0","676246","564","681677","0.18"
"2025-09-13T09:45:13.929Z","Included","auto","No","1933","0","108945","369","111247","0.03"
"2025-09-13T09:44:35.709Z","Included","auto","No","86100","0","243117","530","329747","0.15"
"2025-09-13T09:39:07.506Z","Included","auto","No","3550","0","210969","3627","218146","0.07"
"2025-09-13T09:39:01.068Z","Errored, Not Charged","auto","No","250","0","105148","0","105398","0.03"
"2025-09-13T09:38:26.803Z","Errored, Not Charged","auto","No","0","0","0","0","0","0.00"
"2025-09-13T09:31:38.205Z","Included","auto","No","28166","0","2636871","13146","2678183","0.74"
"2025-09-13T09:30:23.073Z","Errored, Not Charged","auto","No","4818","0","332815","774","338407","0.09"
"2025-09-13T09:25:27.884Z","Errored, Not Charged","auto","No","32200","79430","2395783","6960","2514373","0.67"
"2025-09-13T09:24:59.717Z","Included","auto","No","12309","0","306892","180","319381","0.09"
"2025-09-13T09:24:43.956Z","Errored, Not Charged","auto","No","698","0","105085","54","105837","0.03"
"2025-09-13T09:24:11.730Z","Errored, Not Charged","auto","No","2566","0","412358","282","415206","0.11"
"2025-09-13T09:20:23.147Z","Included","auto","No","7370","0","990528","1480","999378","0.26"
"2025-09-13T09:19:33.099Z","Included","auto","No","130","0","94585","306","95021","0.03"
"2025-09-13T09:19:21.472Z","Errored, Not Charged","auto","No","0","0","0","0","0","0.00"
"2025-09-13T09:18:19.463Z","Errored, Not Charged","auto","No","3414","0","181200","190","184804","0.05"
"2025-09-13T09:18:06.156Z","Included","auto","No","523","0","89811","400","90734","0.02"
"2025-09-13T09:17:09.521Z","Included","auto","No","498","0","89314","377","90189","0.02"
"2025-09-13T09:16:54.339Z","Included","auto","No","519","0","88796","356","89671","0.02"
"2025-09-13T09:16:38.598Z","Included","auto","No","19874","0","68923","387","89184","0.04"
"2025-09-13T09:13:52.859Z","Included","auto","No","1360","0","310396","506","312262","0.08"
"2025-09-13T09:08:46.201Z","Included","auto","No","95925","0","1204414","3582","1303921","0.41"
"2025-09-13T09:05:15.918Z","Included","auto","No","11534","0","2023314","1988","2036836","0.53"
"2025-09-13T09:04:57.917Z","Errored, Not Charged","auto","No","480","0","75336","107","75923","0.02"
"2025-09-13T09:03:25.830Z","Included","auto","No","3831","0","586176","774","590781","0.15"
"2025-09-13T09:02:30.849Z","Included","auto","No","2595","0","350680","1056","354331","0.09"
"2025-09-13T08:56:57.255Z","Errored, Not Charged","auto","No","12273","0","1261846","7539","1281658","0.36"
"2025-09-13T08:56:18.422Z","Included","auto","No","1511","0","169759","530","171800","0.05"
"2025-09-13T08:55:24.720Z","Errored, Not Charged","auto","No","31950","0","183196","259","215405","0.08"
"2025-09-13T08:54:20.146Z","Included","auto","No","5585","0","817150","2341","825076","0.22"
"2025-09-13T08:53:02.414Z","Included","auto","No","76910","0","224547","247","301704","0.13"
"2025-09-13T08:52:30.629Z","Errored, Not Charged","auto","No","991","0","198524","173","199688","0.05"
"2025-09-13T08:51:21.736Z","Errored, Not Charged","auto","No","747","0","98016","50","98813","0.03"
"2025-09-13T08:50:49.578Z","Included","auto","No","1215","0","291636","240","293091","0.08"
"2025-09-13T08:50:23.600Z","Included","auto","No","610","0","289271","132","290013","0.07"
"2025-09-13T08:50:08.486Z","Included","auto","No","367","0","191887","90","192344","0.05"
"2025-09-13T08:49:39.404Z","Included","auto","No","89126","0","197502","195","286823","0.14"
"2025-09-13T08:48:44.257Z","Included","auto","No","263","0","94889","1","95153","0.02"
"2025-09-13T08:48:27.250Z","Included","auto","No","2308","0","187342","78","189728","0.05"
"2025-09-13T08:47:53.566Z","Included","auto","No","950","0","280469","231","281650","0.07"
"2025-09-13T08:47:37.026Z","Errored, Not Charged","auto","No","345","0","185292","144","185781","0.05"
"2025-09-13T08:47:18.170Z","Errored, Not Charged","auto","No","602","0","273818","183","274603","0.07"
"2025-09-13T08:46:53.599Z","Included","auto","No","712","0","90364","88","91164","0.02"
"2025-09-13T08:46:01.082Z","Included","auto","No","531","0","271624","215","272370","0.07"
"2025-09-13T08:45:46.033Z","Errored, Not Charged","auto","No","466","0","178361","202","179029","0.05"
"2025-09-13T08:44:59.312Z","Included","auto","No","1811","0","352674","290","354775","0.09"
"2025-09-13T08:42:28.575Z","Included","auto","No","15767","0","379195","1508","396470","0.12"
"2025-09-13T08:36:25.243Z","Included","auto","No","2613","0","169864","2320","174797","0.05"
"2025-09-13T08:34:18.534Z","Included","auto","No","946","0","83685","338","84969","0.02"
"2025-09-13T08:30:20.169Z","Included","auto","No","2718","0","410806","1174","414698","0.11"
"2025-09-13T08:29:33.892Z","Included","auto","No","4276","0","76697","385","81358","0.02"
"2025-09-13T08:28:37.287Z","Included","auto","No","8349","0","630606","2145","641100","0.17"
"2025-09-13T08:27:58.598Z","Included","auto","No","1147","0","72795","578","74520","0.02"
"2025-09-13T08:27:25.704Z","Included","auto","No","5867","0","66210","325","72402","0.02"
"2025-09-13T08:26:32.445Z","Included","auto","No","157","0","34890","563","35610","0.01"
"2025-09-13T08:25:22.307Z","Errored, Not Charged","auto","No","3981","0","944709","609","949299","0.24"
"2025-09-13T08:25:06.350Z","Included","auto","No","9530","0","154586","982","165098","0.05"
"2025-09-13T08:24:32.238Z","Included","auto","No","5096","0","55636","115","60847","0.02"
"2025-09-13T08:21:04.453Z","Included","auto","No","2820","0","615205","527","618552","0.16"
"2025-09-13T08:19:36.510Z","Included","auto","No","973","0","132613","356","133942","0.04"
"2025-09-13T08:19:01.547Z","Included","auto","No","4813","0","61350","108","66271","0.02"
"2025-09-13T08:16:53.572Z","Errored, Not Charged","auto","No","8471","0","200150","1683","210304","0.07"
"2025-09-13T08:15:32.042Z","Included","auto","No","1244","0","193908","1067","196219","0.05"
"2025-09-13T08:14:27.725Z","Errored, Not Charged","auto","No","335","0","122853","157","123345","0.03"
"2025-09-13T08:14:17.287Z","Errored, Not Charged","auto","No","378","0","60420","240","61038","0.02"
"2025-09-13T08:11:44.351Z","Included","auto","No","40698","0","90643","398","131739","0.06"
"2025-09-13T08:08:11.311Z","Included","auto","No","60457","1137","322137","2335","386066","0.16"
"2025-09-13T08:03:11.809Z","Included","auto","No","36374","99242","436634","18703","590953","0.28"
"2025-09-13T07:59:17.986Z","Included","auto","No","172042","0","636384","764","809190","0.33"
"2025-09-13T07:55:09.857Z","Included","auto","No","16993","0","1327894","1284","1346171","0.35"
"2025-09-13T07:50:13.093Z","Included","auto","No","9619","0","975172","1227","986018","0.26"
"2025-09-13T07:49:42.020Z","Included","auto","No","87520","0","101501","89","189110","0.11"
"2025-09-13T07:42:30.562Z","Included","auto","No","7886","0","1895696","1886","1905468","0.49"
"2025-09-13T07:41:37.699Z","Included","auto","No","879","0","171255","724","172858","0.05"
"2025-09-13T07:40:46.330Z","Included","auto","No","3784","0","167042","101","170927","0.05"
"2025-09-13T07:35:55.906Z","Included","auto","No","64636","91737","2169352","12906","2338631","0.67"
"2025-09-13T07:34:26.880Z","Included","auto","No","103375","0","227407","166","330948","0.16"
"2025-09-13T07:29:19.942Z","Included","claude-4-sonnet","No","130690","158","0","157","131005","0.49"
"2025-09-13T07:15:24.225Z","Included","auto","No","1780","0","287472","694","289946","0.08"
"2025-09-13T07:09:44.574Z","Included","auto","No","89513","0","735117","1242","825872","0.28"
"2025-09-13T07:08:24.491Z","Included","auto","No","233497","181497","4431236","61833","4908063","1.60"
"2025-09-13T07:05:51.937Z","Included","auto","No","3699","0","342007","2440","348146","0.10"
"2025-09-13T07:02:52.277Z","Included","auto","No","89308","0","675583","1271","766162","0.26"
"2025-09-13T06:56:50.189Z","Included","claude-4-sonnet","No","37891","285","2971753","6221","3016150","1.13"
"2025-09-13T06:53:21.239Z","Included","claude-4-sonnet","No","8118","167","1379412","3624","1391321","0.50"
"2025-09-13T06:53:00.760Z","Errored, Not Charged","claude-4-sonnet","No","2293","171","213259","369","216092","0.08"
"2025-09-13T06:51:56.714Z","Errored, Not Charged","claude-4-sonnet","No","3850","330","480499","959","485638","0.17"
"2025-09-13T06:49:13.013Z","Included","auto","No","165589","0","2756655","3442","2925686","0.87"
"2025-09-13T06:47:06.818Z","Errored, Not Charged","claude-4-sonnet","No","38953","108029","999323","11536","1157841","0.54"
"2025-09-13T06:44:48.389Z","Included","claude-4-sonnet","No","9244","244","660654","914","671056","0.25"
"2025-09-13T06:42:59.196Z","Included","auto","No","95221","0","1349394","8252","1452867","0.47"
"2025-09-13T06:42:23.110Z","Errored, Not Charged","claude-4-sonnet","No","9490","156","1258772","1228","1269646","0.43"
"2025-09-13T06:41:55.551Z","Errored, Not Charged","claude-4-sonnet","No","1268","165","602559","569","604561","0.19"
"2025-09-13T06:40:19.225Z","Errored, Not Charged","claude-4-sonnet","No","2922","153","742077","1230","746382","0.25"
"2025-09-13T06:38:58.191Z","Included","claude-4-sonnet","No","4664","155","868595","1593","875007","0.30"
"2025-09-13T06:38:40.024Z","Errored, Not Charged","claude-4-sonnet","No","4451","238","276433","354","281476","0.11"
"2025-09-13T06:38:10.403Z","Errored, Not Charged","claude-4-sonnet","No","1750","155","547022","593","549520","0.18"
"2025-09-13T06:38:04.698Z","Included","auto","No","48850","0","1137492","5274","1191616","0.35"
"2025-09-13T06:38:03.355Z","Errored, Not Charged","claude-4-sonnet","No","713","164","135576","130","136583","0.05"
"2025-09-13T06:37:43.725Z","Errored, Not Charged","auto","No","74929","66123","405001","20541","566594","0.26"
"2025-09-13T06:37:00.669Z","Errored, Not Charged","claude-4-sonnet","No","3918","191","1467395","1438","1472942","0.48"
"2025-09-13T06:36:05.071Z","Errored, Not Charged","auto","No","36825","845021","23984","12929","918759","0.21"
"2025-09-13T06:34:52.046Z","Included","claude-4-sonnet","No","2167","159","390408","1991","394725","0.16"
"2025-09-13T06:34:04.340Z","Errored, Not Charged","claude-4-sonnet","No","1355","159","383435","555","385504","0.13"
"2025-09-13T06:33:41.225Z","Included","claude-4-sonnet","No","127463","157","0","132","127752","0.48"
"2025-09-13T06:31:53.804Z","Included","auto","No","59074","85069","971344","21726","1137213","0.39"
"2025-09-13T06:30:28.836Z","Errored, Not Charged","auto","No","1693","0","497863","315","499871","0.13"
"2025-09-13T06:29:26.341Z","Errored, Not Charged","auto","No","91861","0","204406","212","296479","0.14"
"2025-09-13T06:27:09.361Z","Errored, Not Charged","auto","No","37175","0","738399","639","776213","0.22"
"2025-09-13T06:26:44.462Z","Included","claude-4-sonnet","No","1837","158","378522","546","381063","0.13"
"2025-09-13T06:26:27.739Z","Errored, Not Charged","claude-4-sonnet","No","665","158","249710","549","251082","0.09"
"2025-09-13T06:25:50.644Z","Included","claude-4-sonnet","No","2373","166","369041","1077","372657","0.14"
"2025-09-13T06:25:27.596Z","Errored, Not Charged","claude-4-sonnet","No","5114","2361","357866","953","366294","0.15"
"2025-09-13T06:25:03.339Z","Errored, Not Charged","claude-4-sonnet","No","4166","2629","343911","1011","351717","0.14"
"2025-09-13T06:24:19.835Z","Errored, Not Charged","claude-4-sonnet","No","3553","176","667115","905","671749","0.23"
"2025-09-13T06:23:46.213Z","Included","claude-4-sonnet","No","28","151","109557","141","109877","0.04"
"2025-09-13T06:23:33.788Z","Included","claude-4-sonnet","No","706","213","217970","138","219027","0.07"
"2025-09-13T06:21:30.567Z","Errored, Not Charged","claude-4-sonnet","No","6941","168","1466123","3030","1476262","0.51"
"2025-09-13T06:20:29.999Z","Included","claude-4-sonnet","No","3282","164","599911","1181","604538","0.21"
"2025-09-13T06:19:40.178Z","Included","claude-4-sonnet","No","1379","182","194741","623","196925","0.07"
"2025-09-13T06:18:59.189Z","Errored, Not Charged","claude-4-sonnet","No","1102","210","192965","354","194631","0.07"
"2025-09-13T06:17:47.379Z","Errored, Not Charged","claude-4-sonnet","No","3029","4973","565569","2149","575720","0.22"
"2025-09-13T06:16:58.195Z","Errored, Not Charged","claude-4-sonnet","No","2083","148","551590","1158","554979","0.19"
"2025-09-13T06:15:19.733Z","Included","claude-4-sonnet","No","5248","2451","707165","1981","716845","0.27"
"2025-09-13T06:13:41.145Z","Errored, Not Charged","claude-4-sonnet","No","3269","4419","587047","2625","597360","0.23"
"2025-09-13T06:12:29.901Z","Errored, Not Charged","claude-4-sonnet","No","2182","205","325342","615","328344","0.12"
"2025-09-13T06:11:58.550Z","Included","claude-4-sonnet","No","646","2142","159468","809","163065","0.07"
"2025-09-13T06:10:51.154Z","Included","claude-4-sonnet","No","4289","161","463286","1440","469176","0.18"
"2025-09-13T06:10:40.994Z","Errored, Not Charged","claude-4-sonnet","No","3154","161","72247","192","75754","0.04"
"2025-09-13T06:10:27.344Z","Errored, Not Charged","claude-4-sonnet","No","803","1735","71444","321","74303","0.03"
"2025-09-13T06:10:18.132Z","Included","auto","No","32116","0","2260265","2931","2295312","0.61"
"2025-09-13T06:09:00.236Z","Errored, Not Charged","claude-4-sonnet","No","8662","4956","613965","2797","630380","0.27"
"2025-09-13T06:08:19.469Z","Included","auto","No","54071","94153","68000","24716","240940","0.17"
"2025-09-13T06:07:38.647Z","Errored, Not Charged","claude-4-sonnet","No","62782","12245","468950","6863","550840","0.31"
"2025-09-13T06:06:24.322Z","Errored, Not Charged","auto","No","0","0","0","0","0","0.00"
"2025-09-13T06:05:34.676Z","Errored, Not Charged","auto","No","0","0","0","0","0","0.00"
"2025-09-13T06:01:49.656Z","Included","auto","No","19364","1820","2480743","6489","2508416","0.68"
"2025-09-13T06:00:03.229Z","Errored, Not Charged","auto","No","11570","87050","138385","6500","243505","0.08"
"2025-09-13T05:59:18.632Z","Errored, Not Charged","auto","No","2756","0","664376","468","667600","0.17"
"2025-09-13T05:58:38.356Z","Errored, Not Charged","auto","No","6061","0","1062041","963","1069065","0.28"
"2025-09-13T05:56:36.716Z","Included","auto","No","5197","0","513046","750","518993","0.14"
"2025-09-13T05:53:46.244Z","Included","auto","No","534","0","98576","367","99477","0.03"
"2025-09-13T05:53:28.034Z","Errored, Not Charged","auto","No","3385","0","385617","372","389374","0.10"
"2025-09-13T05:50:31.926Z","Included","auto","No","6824","21824","1191919","5699","1226266","0.41"
"2025-09-13T05:48:57.751Z","Included","auto","No","7260","0","1715237","1956","1724453","0.44"
"2025-09-13T05:47:09.611Z","Included","auto","No","2668","7023","318061","3087","330839","0.12"
"2025-09-13T05:45:09.353Z","Included","auto","No","5669","8648","829968","3434","847719","0.26"
"2025-09-13T05:43:38.537Z","Included","auto","No","8067","0","919249","1424","928740","0.24"
"2025-09-13T05:32:26.577Z","Included","auto","No","67537","0","605276","570","673383","0.22"
"2025-09-13T05:31:29.861Z","Errored, Not Charged","auto","No","13163","0","418725","774","432662","0.12"
"2025-09-13T05:29:24.623Z","Included","auto","No","10030","0","1255247","2703","1267980","0.33"
"2025-09-13T05:28:57.304Z","Included","auto","No","29355","2308","1976329","8575","2016567","0.57"
"2025-09-13T05:28:41.657Z","Included","auto","No","575","0","48929","477","49981","0.01"
"2025-09-13T05:27:52.752Z","Errored, Not Charged","auto","No","60859","44110","25895","9288","140152","0.11"
"2025-09-13T05:24:58.971Z","Included","auto","No","21644","118422","546615","14232","700913","0.36"
"2025-09-13T05:22:54.268Z","Included","auto","No","6713","0","1631486","1846","1640045","0.42"
"2025-09-13T05:21:28.877Z","Errored, Not Charged","auto","No","15758","0","1218102","1228","1235088","0.33"
"2025-09-13T05:18:36.177Z","Included","auto","No","6909","0","1140445","1484","1148838","0.30"
"2025-09-13T05:17:49.886Z","Errored, Not Charged","auto","No","3584","0","906637","892","911113","0.23"
"2025-09-13T05:14:56.248Z","Included","auto","No","14266","0","900591","1482","916339","0.25"
"2025-09-13T05:13:42.607Z","Included","auto","No","3216","0","314980","294","318490","0.08"
"2025-09-13T05:06:38.828Z","Errored, Not Charged","auto","No","17745","0","1912133","2059","1931937","0.50"
"2025-09-13T05:05:22.590Z","Errored, Not Charged","auto","No","79384","0","1877538","1577","1958499","0.56"
"2025-09-13T05:04:07.186Z","Included","auto","No","78957","1922","3082316","7028","3170223","0.89"
"2025-09-13T05:02:23.073Z","Included","auto","No","35658","0","3141269","4904","3181831","0.84"
"2025-09-13T05:00:59.092Z","Included","auto","No","6831","0","1004217","1649","1012697","0.26"
"2025-09-13T04:59:59.517Z","Errored, Not Charged","auto","No","4936","0","317813","540","323289","0.09"
"2025-09-13T04:58:33.918Z","Errored, Not Charged","auto","No","23576","77726","547953","7109","656364","0.20"
"2025-09-13T04:57:03.603Z","Errored, Not Charged","auto","No","34560","0","2241911","1618","2278089","0.60"
"2025-09-13T04:49:51.269Z","Included","auto","No","22348","0","5128929","4874","5156151","1.32"
"2025-09-13T04:49:28.822Z","Errored, Not Charged","auto","No","1970","0","238974","844","241788","0.07"
"2025-09-13T04:47:40.453Z","Errored, Not Charged","auto","No","17420","0","1023925","3723","1045068","0.29"
"2025-09-13T04:47:09.660Z","Included","auto","No","1431","0","206499","167","208097","0.05"
"2025-09-13T04:46:51.057Z","Errored, Not Charged","auto","No","6856","0","465349","339","472544","0.12"
"2025-09-13T04:46:08.486Z","Errored, Not Charged","auto","No","7119","0","54344","55","61518","0.02"
"2025-09-13T04:41:20.129Z","Included","auto","No","42748","0","219648","1936","264332","0.11"
"2025-09-13T04:39:59.389Z","Included","auto","No","11846","0","455216","2742","469804","0.14"
"2025-09-13T04:38:22.072Z","Errored, Not Charged","auto","No","6223","0","340489","583","347295","0.09"
"2025-09-13T04:37:10.928Z","Included","auto","No","20455","90533","62780","8170","181938","0.08"
"2025-09-13T04:35:17.748Z","Errored, Not Charged","auto","No","48137","3784","410258","1746","463925","0.17"
"2025-09-13T04:34:03.879Z","Errored, Not Charged","auto","No","37503","0","1488943","4013","1530459","0.43"
"2025-09-13T04:33:00.750Z","Included","auto","No","32902","82268","28555","24738","168463","0.14"
"2025-09-13T04:31:25.131Z","Included","auto","No","13672","235080","109336","4978","363066","0.09"
"2025-09-13T04:29:43.225Z","Included","auto","No","46789","84920","524090","5317","661116","0.21"
"2025-09-13T04:28:13.804Z","Included","auto","No","89120","0","1206338","1577","1297035","0.40"
"2025-09-13T04:27:18.851Z","Included","auto","No","12467","0","2988838","4964","3006269","0.78"
"2025-09-13T04:26:28.585Z","Errored, Not Charged","auto","No","8485","0","904639","2468","915592","0.24"
"2025-09-13T04:24:08.544Z","Errored, Not Charged","auto","No","72477","0","1474791","1409","1548677","0.45"
"2025-09-13T04:19:08.400Z","Included","auto","No","40960","0","2399300","2943","2443203","0.65"
"2025-09-13T04:17:40.330Z","Errored, Not Charged","auto","No","3845","3942","411302","2180","421269","0.13"
"2025-09-13T04:16:38.117Z","Errored, Not Charged","auto","No","18563","1225","174688","2189","196665","0.08"
"2025-09-13T04:16:09.075Z","Included","auto","No","0","0","0","0","0","0.00"
"2025-09-13T04:13:38.907Z","Included","auto","No","15854","976","521175","3018","541023","0.16"
"2025-09-13T04:13:14.182Z","Errored, Not Charged","auto","No","2178","0","42938","1021","46137","0.02"
"2025-09-13T04:12:03.934Z","Errored, Not Charged","auto","No","983","737","81696","1251","84667","0.03"
"2025-09-13T04:09:24.765Z","Included","auto","No","6455","1640","299227","3021","310343","0.11"
"2025-09-13T04:08:06.628Z","Included","auto","No","8829","83633","25425","8108","125995","0.06"
"2025-09-13T04:07:44.971Z","Included","auto","No","0","0","0","0","0","0.00"
"2025-09-13T04:07:16.651Z","Included","auto","No","3150","0","334638","104","337892","0.09"
"2025-09-13T04:03:50.675Z","Errored, Not Charged","auto","No","13656","0","732865","6887","753408","0.22"
"2025-09-13T04:02:33.189Z","Errored, Not Charged","auto","No","8083","0","651702","1333","661118","0.18"
"2025-09-13T03:59:34.743Z","Included","auto","No","75411","0","122514","377","198302","0.11"
"2025-09-13T03:36:11.908Z","Included","auto","No","7867","0","1562071","2354","1572292","0.41"
"2025-09-13T03:28:54.568Z","Included","auto","No","152329","80714","8341080","18221","8592344","2.32"
"2025-09-13T03:27:31.170Z","Included","auto","No","4843","0","686825","1845","693513","0.18"
"2025-09-13T03:26:34.395Z","Errored, Not Charged","auto","No","1621","3237","383181","1704","389743","0.12"
"2025-09-13T03:26:02.523Z","Errored, Not Charged","auto","No","2997","898","367621","612","372128","0.10"
"2025-09-13T03:23:59.130Z","Included","auto","No","96894","0","1417684","2109","1516687","0.46"
"2025-09-13T03:21:16.858Z","Errored, Not Charged","auto","No","22771","0","912806","905","936482","0.25"
"2025-09-13T03:20:15.507Z","Errored, Not Charged","auto","No","51878","0","754033","853","806764","0.24"
"2025-09-13T03:18:48.992Z","Included","auto","No","9466","0","79354","285","89105","0.03"
"2025-09-13T03:11:02.485Z","Included","auto","No","8469","0","1588802","1838","1599109","0.41"
"2025-09-13T03:10:52.117Z","Errored, Not Charged","auto","No","21213","0","57901","171","79285","0.04"
"2025-09-13T03:09:49.884Z","Included","auto","No","503","0","76009","279","76791","0.02"
"2025-09-13T03:09:40.583Z","Included","auto","No","345","0","75665","355","76365","0.02"
"2025-09-13T03:08:58.531Z","Errored, Not Charged","auto","No","17771","0","475529","904","494204","0.14"
"2025-09-13T03:08:48.178Z","Errored, Not Charged","auto","No","6966","0","50476","175","57617","0.02"
"2025-09-13T03:03:43.468Z","Included","auto","No","3086","0","319361","1287","323734","0.09"
"2025-09-13T03:03:33.652Z","Errored, Not Charged","auto","No","172","0","51406","118","51696","0.01"
"2025-09-13T02:57:21.184Z","Errored, Not Charged","auto","No","157","0","51117","50","51324","0.01"
"2025-09-13T02:57:08.122Z","Errored, Not Charged","auto","No","379","0","101444","84","101907","0.03"
"2025-09-13T02:57:03.101Z","Included","auto","No","148","0","50476","50","50674","0.01"
"2025-09-13T02:56:42.488Z","Errored, Not Charged","auto","No","3494","0","146861","166","150521","0.04"
"2025-09-13T02:55:41.535Z","Included","auto","No","2350","0","382375","534","385259","0.10"
"2025-09-13T02:53:53.290Z","Errored, Not Charged","auto","No","18010","737","130643","22723","172113","0.11"
"2025-09-13T02:52:41.651Z","Errored, Not Charged","auto","No","0","0","0","0","0","0.00"
"2025-09-13T02:50:18.637Z","Errored, Not Charged","auto","No","2791","0","1252277","907","1255975","0.32"
"2025-09-13T02:49:43.958Z","Included","auto","No","9372","0","103261","252","112885","0.04"
"2025-09-13T02:49:31.931Z","Included","auto","No","574","0","111714","188","112476","0.03"
"2025-09-13T02:47:45.382Z","Included","auto","No","8586","0","2046210","2271","2057067","0.53"
"2025-09-13T02:47:30.563Z","Errored, Not Charged","auto","No","5951","0","199847","148","205946","0.06"
"2025-09-13T02:45:34.031Z","Included","auto","No","46153","11599","484850","7131","549733","0.19"
"2025-09-13T02:44:52.901Z","Included","auto","No","4144","0","502356","1051","507551","0.13"
"2025-09-13T02:44:25.215Z","Errored, Not Charged","auto","No","1445","0","393162","988","395595","0.10"
"2025-09-13T02:44:07.130Z","Errored, Not Charged","auto","No","411","0","292044","161","292616","0.07"
"2025-09-13T02:43:46.285Z","Errored, Not Charged","auto","No","889","0","288117","398","289404","0.07"
"2025-09-13T02:43:01.107Z","Included","auto","No","1013","1585","189809","764","193171","0.06"
"2025-09-13T02:42:28.626Z","Included","auto","No","536","0","94041","502","95079","0.03"
"2025-09-13T02:41:41.016Z","Included","auto","No","608","0","93434","348","94390","0.03"
"2025-09-13T02:41:28.695Z","Included","auto","No","492","0","92943","464","93899","0.03"
"2025-09-13T02:40:01.286Z","Included","auto","No","473","0","92471","338","93282","0.02"
"2025-09-13T02:39:28.048Z","Included","auto","No","68637","0","115620","376","184633","0.10"
"2025-09-13T02:38:08.427Z","Included","auto","No","868","0","90575","189","91632","0.02"
"2025-09-13T02:37:43.162Z","Included","auto","No","413","0","90727","137","91277","0.02"
"2025-09-13T02:37:34.326Z","Included","auto","No","153","0","90575","261","90989","0.02"
"2025-09-13T02:36:52.369Z","Errored, Not Charged","auto","No","1786","0","265983","268","268037","0.07"
"2025-09-13T02:34:49.803Z","Included","auto","No","3940","0","594290","848","599078","0.16"
"2025-09-13T02:31:39.035Z","Included","auto","No","70517","76954","1093148","21467","1262086","0.43"
"2025-09-13T02:31:08.543Z","Included","auto","No","443","0","96334","321","97098","0.03"
"2025-09-13T02:30:28.650Z","Included","auto","No","286977","38360","4774451","16932","5116720","1.55"
"2025-09-13T02:24:34.991Z","Included","auto","No","871","0","203100","175","204146","0.05"
"2025-09-13T02:23:01.966Z","Included","auto","No","2342","0","198626","751","201719","0.06"
"2025-09-13T02:22:52.491Z","Included","auto","No","579","0","65839","111","66529","0.02"
"2025-09-13T02:22:39.193Z","Errored, Not Charged","auto","No","125","0","65137","567","65829","0.02"
"2025-09-13T02:22:23.742Z","Errored, Not Charged","auto","No","698","0","63812","576","65086","0.02"
"2025-09-13T02:20:54.940Z","Included","auto","No","2188","0","314390","650","317228","0.08"
"2025-09-13T02:20:31.714Z","Included","auto","No","4126","0","119467","235","123828","0.03"
"2025-09-13T02:18:59.131Z","Included","auto","No","35717","0","142502","452","178671","0.07"
"2025-09-13T02:17:39.597Z","Errored, Not Charged","auto","No","72535","0","2135545","5090","2213170","0.63"
"2025-09-13T02:16:41.139Z","Errored, Not Charged","auto","No","33686","0","23986","59","57731","0.04"
"2025-09-13T02:14:45.994Z","Errored, Not Charged","auto","No","0","0","0","0","0","0.00"
"2025-09-13T02:10:38.773Z","Included","auto","No","28856","0","1384978","2812","1416646","0.39"
"2025-09-13T02:04:35.013Z","Errored, Not Charged","auto","No","40701","0","564249","1149","606099","0.19"
"2025-09-13T02:04:24.457Z","Errored, Not Charged","auto","No","42835","0","71679","128","114642","0.06"
"2025-09-13T01:52:06.264Z","Errored, Not Charged","auto","No","198896","17624","2510332","8286","2735138","0.86"
"2025-09-13T01:51:38.848Z","Included","auto","No","1055","0","222434","614","224103","0.06"
"2025-09-13T01:50:57.247Z","Errored, Not Charged","auto","No","11564","0","409966","246","421776","0.12"
"2025-09-13T01:49:44.432Z","Included","auto","No","42503","0","253842","1007","297352","0.11"
"2025-09-13T01:47:02.072Z","Included","auto","No","4596","0","1768647","1452","1774695","0.45"
"2025-09-13T01:46:25.242Z","Errored, Not Charged","auto","No","1644","0","429314","722","431680","0.11"
"2025-09-13T01:44:36.862Z","Included","auto","No","40765","0","1418403","2253","1461421","0.40"
"2025-09-13T01:44:28.570Z","Errored, Not Charged","auto","No","4430","0","108702","221","113353","0.03"
"2025-09-13T01:44:00.808Z","Included","auto","No","45846","0","564074","1352","611272","0.19"
"2025-09-13T01:42:47.219Z","Included","auto","No","584","0","103753","76","104413","0.03"
"2025-09-13T01:42:05.771Z","Included","auto","No","887","0","256210","154","257251","0.07"
"2025-09-13T01:41:47.534Z","Included","auto","No","131","0","50767","65","50963","0.01"
"2025-09-13T01:41:19.147Z","Errored, Not Charged","auto","No","3682","0","297642","218","301542","0.08"
"2025-09-13T01:40:59.517Z","Included","auto","No","667","0","98468","126","99261","0.03"
"2025-09-13T01:39:52.071Z","Errored, Not Charged","auto","No","46913","89758","384191","4163","525025","0.17"
"2025-09-13T01:36:18.625Z","Errored, Not Charged","auto","No","40188","0","410941","1266","452395","0.15"
"2025-09-13T01:35:04.689Z","Included","auto","No","104132","0","2118054","2600","2224786","0.64"
"2025-09-13T01:34:47.150Z","Included","auto","No","3727","0","67133","306","71166","0.02"
"2025-09-13T01:33:51.813Z","Included","auto","No","3187","0","620824","623","624634","0.16"
"2025-09-13T01:33:41.203Z","Errored, Not Charged","auto","No","185","0","67133","101","67419","0.02"
"2025-09-13T01:32:56.394Z","Errored, Not Charged","auto","No","4869","0","389705","657","395231","0.10"
"2025-09-13T01:31:31.645Z","Included","auto","No","37103","0","1028593","4106","1069802","0.31"
"2025-09-13T01:30:34.014Z","Errored, Not Charged","auto","No","12430","0","57226","2165","71821","0.04"
"2025-09-13T01:27:48.569Z","Included","auto","No","13131","0","863830","5991","882952","0.25"
"2025-09-13T01:25:51.388Z","Errored, Not Charged","auto","No","6094","4557","469947","5048","485646","0.17"
"2025-09-13T01:25:43.721Z","Errored, Not Charged","auto","No","14811","0","23861","58","38730","0.02"
"2025-09-13T01:25:13.409Z","Aborted, Not Charged","auto","No","0","0","0","0","0","0.00"
"2025-09-13T01:24:15.626Z","Included","auto","No","11959","0","174750","2022","188731","0.06"
"2025-09-13T01:23:42.097Z","Errored, Not Charged","auto","No","5692","0","48609","1604","55905","0.02"
"2025-09-13T01:22:39.526Z","Included","auto","No","1315","0","127466","717","129498","0.04"
"2025-09-13T01:22:21.155Z","Errored, Not Charged","auto","No","166","0","62155","502","62823","0.02"
"2025-09-13T01:21:52.300Z","Errored, Not Charged","auto","No","1031","0","182543","545","184119","0.05"
"2025-09-13T01:19:19.023Z","Included","auto","No","5927","0","909114","5381","920422","0.25"
"2025-09-13T01:18:53.732Z","Errored, Not Charged","auto","No","1525","977","108070","1045","111617","0.04"
"2025-09-13T01:14:30.075Z","Included","auto","No","760","0","119752","118","120630","0.03"
"2025-09-13T01:13:53.754Z","Included","auto","No","6209","0","951270","1375","958854","0.25"
"2025-09-13T01:10:58.363Z","Included","auto","No","2602","0","467368","850","470820","0.12"
"2025-09-13T01:08:59.011Z","Included","auto","No","78040","0","468375","684","547099","0.20"
"2025-09-13T01:08:08.896Z","Included","auto","No","270099","32217","2543719","17349","2863384","0.98"
"2025-09-13T01:07:57.496Z","Errored, Not Charged","auto","No","11556","0","41471","129","53156","0.02"
"2025-09-13T01:06:00.497Z","Included","auto","No","319","0","56816","48","57183","0.01"
"2025-09-13T01:05:14.261Z","Included","auto","No","335","0","56482","141","56958","0.02"
"2025-09-13T01:03:00.880Z","Errored, Not Charged","auto","No","14694","0","1082378","2316","1099388","0.29"
"2025-09-13T01:00:02.526Z","Errored, Not Charged","auto","No","170095","0","1371369","2639","1544103","0.52"
"2025-09-13T00:57:02.067Z","Included","auto","No","199","0","56284","185","56668","0.02"
"2025-09-13T00:56:20.620Z","Included","auto","No","362","0","112082","62","112506","0.03"
"2025-09-13T00:55:54.426Z","Included","auto","No","518","0","111150","140","111808","0.03"
"2025-09-13T00:55:46.294Z","Included","auto","No","290","0","55119","237","55646","0.02"
"2025-09-13T00:54:47.731Z","Included","auto","No","1903","0","379538","833","382274","0.10"
"2025-09-13T00:54:33.828Z","Included","auto","No","3594","0","49630","299","53523","0.02"
"2025-09-13T00:52:25.292Z","Errored, Not Charged","auto","No","150738","867010","345091","11014","1373853","0.41"
"2025-09-13T00:51:19.771Z","Included","auto","No","25004","80700","485388","22424","613516","0.24"
"2025-09-13T00:49:43.383Z","Included","auto","No","2142","0","781681","1157","784980","0.20"
"2025-09-13T00:49:32.858Z","Errored, Not Charged","auto","No","5281","0","103234","86","108601","0.03"
"2025-09-13T00:46:08.876Z","Included","auto","No","4496","0","307300","2309","314105","0.09"
"2025-09-13T00:45:11.845Z","Included","auto","No","3223","0","744947","1059","749229","0.19"
"2025-09-13T00:45:04.752Z","Errored, Not Charged","auto","No","587","0","104154","83","104824","0.03"
"2025-09-13T00:44:41.596Z","Errored, Not Charged","auto","No","805","0","414242","382","415429","0.11"
"2025-09-13T00:44:32.062Z","Errored, Not Charged","auto","No","474","0","101474","47","101995","0.03"
"2025-09-13T00:42:56.949Z","Included","auto","No","6692","0","596776","750","604218","0.16"
"2025-09-13T00:40:17.625Z","Included","auto","No","5045","0","582818","2482","590345","0.16"
"2025-09-13T00:40:04.093Z","Errored, Not Charged","auto","No","70480","0","23836","99","94415","0.08"
"2025-09-13T00:26:44.540Z","Included","auto","No","86834","61883","378475","1353","528545","0.20"
"2025-09-13T00:26:17.653Z","Included","auto","No","606","61340","183137","209","245292","0.06"
"2025-09-13T00:25:50.240Z","Errored, Not Charged","auto","No","320","60739","90668","210","151937","0.03"
"2025-09-13T00:25:07.697Z","Included","auto","No","66835","59997","204591","285","331708","0.13"
"2025-09-13T00:19:51.038Z","Included","auto","No","141867","55403","3356647","3545","3557462","1.00"
"2025-09-13T00:17:08.561Z","Errored, Not Charged","auto","No","85844","198051","989463","14173","1287531","0.41"
"2025-09-13T00:14:40.199Z","Included","auto","No","363324","218295","8237260","41529","8860408","2.62"
"2025-09-13T00:12:08.441Z","Included","auto","No","88748","92597","581093","1182","763620","0.25"
"2025-09-13T00:09:17.640Z","Errored, Not Charged","auto","No","38585","88693","847339","530","975147","0.27"
"2025-09-13T00:06:55.891Z","Included","auto","No","12457","51446","1097985","4410","1166298","0.31"
"2025-09-13T00:04:06.970Z","Included","auto","No","2684","49427","467880","872","520863","0.13"
"2025-09-13T00:03:06.695Z","Errored, Not Charged","auto","No","4256","45668","595060","1227","646211","0.16"
"2025-09-12T23:59:06.126Z","Included","auto","No","3035","43219","495716","1338","543308","0.14"
"2025-09-12T23:58:52.257Z","Included","auto","No","8097","42842","61391","174","112504","0.03"
"2025-09-12T23:58:36.559Z","Included","auto","No","173","42280","68805","605","111863","0.03"
"2025-09-12T23:57:45.682Z","Errored, Not Charged","auto","No","3694","38509","522764","1948","566915","0.15"
"2025-09-12T23:57:19.878Z","Errored, Not Charged","auto","No","1265","37162","248994","1073","288494","0.07"
"2025-09-12T23:57:10.944Z","Errored, Not Charged","auto","No","146","0","61391","112","61649","0.02"
"2025-09-12T23:56:48.096Z","Errored, Not Charged","auto","No","3652","34748","237818","595","276813","0.07"
"2025-09-12T23:54:21.152Z","Included","auto","No","2771","32655","462898","696","499020","0.13"
"2025-09-12T23:53:04.296Z","Errored, Not Charged","auto","No","9182","26031","780756","1508","817477","0.21"
"2025-09-12T23:51:58.603Z","Included","auto","No","13303","73968","1055572","1109","1143952","0.29"
"2025-09-12T23:50:29.056Z","Errored, Not Charged","auto","No","5708","62278","581875","1134","650995","0.17"
"2025-09-12T23:49:12.412Z","Errored, Not Charged","auto","No","56716","59438","817567","722","934443","0.27"
"2025-09-12T23:43:20.288Z","Errored, Not Charged","auto","No","23009","84980","462511","991","571491","0.16"
"2025-09-12T23:42:10.766Z","Errored, Not Charged","auto","No","4242","81240","1476687","1308","1563477","0.39"
"2025-09-12T23:41:50.309Z","Included","auto","No","1002","80018","110288","923","192231","0.04"
"2025-09-12T23:39:30.335Z","Included","auto","No","1045","78872","109244","1726","190887","0.05"
"2025-09-12T23:38:29.836Z","Included","auto","No","561","77694","108684","2363","189302","0.05"
"2025-09-12T23:38:15.890Z","Errored, Not Charged","auto","No","0","0","0","0","0","0.00"
"2025-09-12T23:37:49.746Z","Included","auto","No","1953","74703","104499","2099","183254","0.05"
"2025-09-12T23:37:33.723Z","Errored, Not Charged","auto","No","0","72420","0","7","72427","0.01"
"2025-09-12T23:36:52.098Z","Errored, Not Charged","auto","No","0","69904","0","7","69911","0.01"
"2025-09-12T23:36:13.674Z","Errored, Not Charged","auto","No","688","0","98336","2236","101260","0.03"
"2025-09-12T23:33:39.371Z","Included","auto","No","8028","0","1698706","3240","1709974","0.45"
"2025-09-12T23:31:35.984Z","Included","auto","No","11668","0","1627688","3861","1643217","0.43"
"2025-09-12T23:28:42.814Z","Included","auto","No","1098","0","155143","1886","158127","0.05"
"2025-09-12T23:26:45.760Z","Included","auto","No","3112","0","153122","10654","166888","0.08"
"2025-09-12T23:25:54.674Z","Included","auto","No","2272","0","530413","889","533574","0.14"
"2025-09-12T23:23:44.852Z","Included","auto","No","1137","0","154411","194","155742","0.04"
"2025-09-12T23:22:24.249Z","Included","auto","No","4096","0","797716","1151","802963","0.21"
"2025-09-12T23:17:39.653Z","Included","auto","No","18014","0","416855","683","435552","0.12"
"2025-09-12T23:17:13.182Z","Errored, Not Charged","auto","No","5051","0","58854","134","64039","0.02"
"2025-09-12T23:11:13.736Z","Included","auto","No","1983","0","487043","501","489527","0.13"
"2025-09-12T23:08:07.588Z","Included","auto","No","43246","947","508069","19430","571692","0.22"
"2025-09-12T23:06:43.996Z","Errored, Not Charged","auto","No","0","0","0","0","0","0.00"
"2025-09-12T23:04:16.105Z","Included","auto","No","18593","0","530463","8606","557662","0.19"
"2025-09-12T23:03:38.420Z","Included","auto","No","398","0","98436","150","98984","0.03"
"2025-09-12T23:03:14.709Z","Included","auto","No","313","0","98124","289","98726","0.03"
"2025-09-12T23:02:45.559Z","Included","auto","No","742","0","97383","203","98328","0.03"
"2025-09-12T23:02:25.914Z","Included","auto","No","325","0","97059","633","98017","0.03"
"2025-09-12T23:02:20.208Z","Included","auto","No","883","0","96177","170","97230","0.03"
"2025-09-12T23:02:07.199Z","Included","auto","No","1595","0","94583","788","96966","0.03"
"2025-09-12T23:01:42.377Z","Included","auto","No","526","0","94058","1482","96066","0.03"
"2025-09-12T23:01:09.310Z","Included","auto","No","2562","0","91497","414","94473","0.03"
"2025-09-12T23:00:12.121Z","Included","auto","No","182","0","91316","2434","93932","0.03"
"2025-09-12T22:59:39.917Z","Errored, Not Charged","auto","No","31225","0","58972","358","90555","0.05"
"2025-09-12T22:58:52.175Z","Errored, Not Charged","auto","No","1745","0","163212","171","165128","0.04"
"2025-09-12T22:58:25.534Z","Included","auto","No","22069","0","267478","1094","290641","0.09"
"2025-09-12T22:56:11.877Z","Errored, Not Charged","auto","No","215016","22598","5396862","18815","5653291","1.64"
"2025-09-12T22:55:46.201Z","Errored, Not Charged","auto","No","33458","0","142451","285","176194","0.07"
"2025-09-12T22:54:43.668Z","Included","auto","No","65061","0","510454","642","576157","0.20"
"2025-09-12T22:53:05.342Z","Included","auto","No","750","84409","206568","160","291887","0.07"
"2025-09-12T22:52:58.476Z","Errored, Not Charged","auto","No","158","83926","102904","117","187105","0.04"
"2025-09-12T22:50:11.158Z","Errored, Not Charged","auto","No","50386","28679","1209649","4895","1293609","0.38"
"2025-09-12T22:49:32.012Z","Included","auto","No","93394","80777","1883016","1096","2058283","0.58"
"2025-09-12T22:48:23.710Z","Errored, Not Charged","auto","No","21239","198980","26991","17450","264660","0.12"
"2025-09-12T22:48:21.420Z","Errored, Not Charged","auto","No","0","0","0","0","0","0.00"
"2025-09-12T22:47:26.287Z","Errored, Not Charged","auto","No","0","98799","0","5","98804","0.01"
"2025-09-12T22:45:52.658Z","Errored, Not Charged","auto","No","0","98795","0","475","99270","0.02"
"2025-09-12T22:43:55.985Z","Included","auto","No","41581","51877","823628","1314","918400","0.26"
"2025-09-12T22:43:18.926Z","Included","auto","No","960","51050","233312","342","285664","0.07"
"2025-09-12T22:41:08.735Z","Included","auto","No","2543","48667","454736","1049","506995","0.13"
"2025-09-12T22:40:42.493Z","Included","auto","No","1636","46938","369893","463","418930","0.10"
"2025-09-12T22:39:22.623Z","Included","auto","No","2004","806","331890","840","335540","0.08"
"2025-09-12T22:39:00.434Z","Included","auto","No","1051","44391","70135","407","115984","0.03"
"2025-09-12T22:30:37.526Z","Included","auto","No","61009","30660","2274635","5243","2371547","0.66"
"2025-09-12T22:29:58.410Z","Included","auto","No","162348","1171895","4673453","15463","6023159","1.56"
"2025-09-12T22:29:10.535Z","Included","auto","No","146","80485","101129","328","182088","0.04"
"2025-09-12T22:28:57.811Z","Errored, Not Charged","auto","No","660","79732","99888","417","180697","0.04"
"2025-09-12T22:28:13.952Z","Errored, Not Charged","auto","No","1675","78293","395502","815","476285","0.12"
"2025-09-12T22:27:36.967Z","Included","auto","No","29856","181801","79941","17621","309219","0.14"
"2025-09-12T22:26:20.757Z","Errored, Not Charged","auto","No","7526","77760","1143306","3832","1232424","0.36"
"2025-09-12T22:26:12.137Z","Errored, Not Charged","auto","No","93103","87337","1160848","2953","1344241","0.41"
"2025-09-12T22:24:28.901Z","Errored, Not Charged","auto","No","64776","175379","25928","11286","277369","0.14"
"2025-09-12T22:18:17.057Z","Included","auto","No","20932","67722","1806336","9067","1904057","0.52"
"2025-09-12T22:17:22.917Z","Errored, Not Charged","auto","No","80377","66131","179521","3981","330010","0.15"
"2025-09-12T22:15:56.715Z","Errored, Not Charged","auto","No","41769","61435","5316752","5478","5425434","1.40"
"2025-09-12T22:12:32.619Z","Errored, Not Charged","auto","No","25580","33761","1300677","2123","1362141","0.36"
"2025-09-12T22:09:29.105Z","Errored, Not Charged","auto","No","42535","181440","1052840","10063","1286878","0.37"
"2025-09-12T22:09:14.380Z","Errored, Not Charged","auto","No","905","87115","212091","280","300391","0.07"
"2025-09-12T22:09:07.554Z","Errored, Not Charged","auto","No","387","86519","105356","228","192490","0.04"
"2025-09-12T22:08:46.653Z","Errored, Not Charged","auto","No","1367","85311","523434","417","610529","0.15"
"2025-09-12T22:06:46.971Z","Errored, Not Charged","auto","No","17492","54153","624071","564","696280","0.18"
"2025-09-12T22:02:36.319Z","Errored, Not Charged","auto","No","91410","80678","3159534","3861","3335483","0.91"
"2025-09-12T22:02:30.680Z","Errored, Not Charged","auto","No","361","79989","99545","129","180024","0.04"
"2025-09-12T22:02:13.417Z","Included","auto","No","397","79566","99149","235","179347","0.04"
"2025-09-12T22:02:06.036Z","Included","auto","No","4170","79108","94980","267","178525","0.04"
"2025-09-12T22:01:30.646Z","Included","auto","No","3834","74574","189839","610","268857","0.06"
"2025-09-12T22:01:13.390Z","Errored, Not Charged","auto","No","4201","74072","90455","214","168942","0.04"
"2025-09-12T22:00:50.502Z","Included","auto","No","1222","73099","375024","196","449541","0.11"
"2025-09-12T22:00:20.976Z","Errored, Not Charged","auto","No","2614","70648","274028","972","348262","0.09"
"2025-09-12T21:59:27.822Z","Errored, Not Charged","auto","No","68224","52946","156734","301","278205","0.12"
"2025-09-12T21:52:59.316Z","Errored, Not Charged","auto","No","49367","111413","609740","806","771326","0.22"
"2025-09-12T21:49:53.719Z","Errored, Not Charged","auto","No","11680","95865","100151","60","207756","0.05"
"2025-09-12T21:47:59.669Z","Included","auto","No","9944","84089","1344694","924","1439651","0.36"
"2025-09-12T21:46:46.108Z","Errored, Not Charged","auto","No","16814","74947","368247","443","460451","0.12"
"2025-09-12T21:46:15.384Z","Included","auto","No","886","74096","183200","224","258406","0.06"
"2025-09-12T21:46:09.969Z","Errored, Not Charged","auto","No","569","73682","90842","57","165150","0.03"
"2025-09-12T21:46:00.368Z","Errored, Not Charged","auto","No","137","73149","90706","123","164115","0.03"
"2025-09-12T21:45:43.604Z","Errored, Not Charged","auto","No","1735","65512","334644","372","402263","0.10"
"2025-09-12T21:43:59.056Z","Errored, Not Charged","auto","No","56247","61354","591296","440","709337","0.22"
"2025-09-12T21:39:26.763Z","Included","auto","No","17384","30369","436811","886","485450","0.13"
"2025-09-12T21:37:01.210Z","Errored, Not Charged","auto","No","137036","186238","1283924","7731","1614929","0.51"
"2025-09-12T21:21:26.075Z","Included","auto","No","52822","168039","335686","15868","572415","0.22"
"2025-09-12T21:19:47.533Z","Included","auto","No","109784","74987","1434817","1610","1621198","0.49"
"2025-09-12T21:18:30.349Z","Errored, Not Charged","auto","No","280","67121","93571","42","161014","0.03"
"2025-09-12T21:18:01.072Z","Errored, Not Charged","auto","No","571","66706","186452","121","253850","0.06"
"2025-09-12T21:17:06.366Z","Errored, Not Charged","auto","No","85950","63978","652751","486","803165","0.26"
"2025-09-12T21:16:32.516Z","Errored, Not Charged","auto","No","2623","61355","266553","235","330766","0.08"
"2025-09-12T21:15:54.562Z","Errored, Not Charged","auto","No","1478","60631","86537","119","148765","0.03"
"2025-09-12T21:15:27.894Z","Included","auto","No","1882","58710","257243","267","318102","0.08"
"2025-09-12T21:14:54.055Z","Included","auto","No","5241","58936","427087","499","491763","0.12"
"2025-09-12T21:13:53.894Z","Included","auto","No","57936","53445","268083","269","379733","0.13"
"2025-09-12T21:04:05.426Z","Included","auto","No","28440","91939","414942","282","535603","0.15"
"2025-09-12T21:02:00.344Z","Included","auto","No","21448","68926","1201982","1194","1293550","0.34"
"2025-09-12T21:01:28.755Z","Errored, Not Charged","auto","No","5670","62399","683501","449","752019","0.19"
"2025-09-12T21:01:03.649Z","Errored, Not Charged","auto","No","1375","61138","574343","432","637288","0.16"
"2025-09-12T21:00:41.674Z","Included","auto","No","4022","59478","400364","353","464217","0.11"
"2025-09-12T21:00:17.766Z","Included","auto","No","4237","59167","75658","109","139171","0.03"
"2025-09-12T20:59:51.941Z","Included","auto","No","55690","56711","495192","569","608162","0.19"
"2025-09-12T20:58:48.695Z","Errored, Not Charged","auto","No","13346","46018","922287","2530","984181","0.26"
"2025-09-12T20:51:56.551Z","Included","auto","No","179996","0","56406","650","237052","0.20"
"2025-09-12T20:48:31.821Z","Included","auto","No","39541","76089","89381","14059","219070","0.12"
"2025-09-12T20:44:51.599Z","Errored, Not Charged","auto","No","111299","1603","2403451","11963","2528316","0.77"
"2025-09-12T20:26:59.662Z","Included","auto","No","27679","0","3137032","6328","3171039","0.84"
"2025-09-12T20:24:03.201Z","Errored, Not Charged","auto","No","5720","0","416418","291","422429","0.11"
"2025-09-12T20:21:01.889Z","Included","auto","No","1431","0","132571","899","134901","0.04"
"2025-09-12T20:19:35.710Z","Included","auto","No","22845","0","860027","2426","885298","0.25"
"2025-09-12T20:16:46.957Z","Included","auto","No","47524","1024","1293305","4265","1346118","0.39"
"2025-09-12T20:14:49.452Z","Errored, Not Charged","auto","No","19475","93178","23826","11736","148215","0.08"
"2025-09-12T20:14:25.772Z","Errored, Not Charged","auto","No","95072","0","485395","273","580740","0.22"
"2025-09-12T20:13:25.357Z","Included","auto","No","104797","0","1144249","1255","1250301","0.40"
"2025-09-12T19:59:59.563Z","Included","auto","No","2551","0","650109","657","653317","0.17"
"2025-09-12T19:53:22.345Z","Errored, Not Charged","auto","No","81286","0","210216","171","291673","0.13"
"2025-09-12T19:44:45.772Z","Included","auto","No","77419","774687","3322533","9038","4183677","1.06"
"2025-09-12T19:40:08.571Z","Included","auto","No","144","0","43155","221","43520","0.01"
"2025-09-12T19:39:45.664Z","Errored, Not Charged","auto","No","509","0","84773","276","85558","0.02"
"2025-09-12T19:39:39.324Z","Errored, Not Charged","auto","No","132","0","41962","50","42144","0.01"
"2025-09-12T19:38:53.712Z","Errored, Not Charged","auto","No","2504","0","199362","779","202645","0.06"
"2025-09-12T19:37:54.798Z","Included","auto","No","3417","0","554719","1612","559748","0.15"
"2025-09-12T19:37:37.749Z","Errored, Not Charged","auto","No","13325","97296","25365","3936","139922","0.05"
"2025-09-12T19:36:21.482Z","Errored, Not Charged","auto","No","7681","0","1065308","858","1073847","0.28"
"2025-09-12T19:34:38.667Z","Errored, Not Charged","auto","No","2676","0","1158515","830","1162021","0.30"
"2025-09-12T19:34:26.920Z","Errored, Not Charged","auto","No","144","0","103852","46","104042","0.03"
"2025-09-12T19:31:30.702Z","Errored, Not Charged","auto","No","15819","0","2258580","1251","2275650","0.59"
"2025-09-12T19:30:43.784Z","Included","auto","No","183017","22976","2640213","16182","2862388","0.91"
"2025-09-12T19:26:23.032Z","Errored, Not Charged","auto","No","135793","0","3427093","2557","3565443","1.00"
"2025-09-12T19:24:27.398Z","Errored, Not Charged","auto","No","90905","2880","2155812","7184","2256781","0.68"
"2025-09-12T19:17:26.242Z","Included","auto","No","1308","0","269429","277","271014","0.07"
"2025-09-12T19:14:54.462Z","Included","auto","No","82276","0","1123357","2637","1208270","0.37"
"2025-09-12T14:03:04.376Z","Included","auto","No","12308","0","190745","483","203536","0.06"
"2025-09-12T14:00:22.167Z","Errored, Not Charged","auto","No","20694","0","296136","467","317297","0.10"
"2025-09-12T13:58:54.649Z","Included","auto","No","97762","0","135533","218","233513","0.13"
"2025-09-12T13:57:45.708Z","Included","auto","No","49152","0","521323","785","571260","0.18"
"2025-09-12T13:55:55.300Z","Included","auto","No","15566","0","143492","447","159505","0.05"
"2025-09-12T13:55:37.136Z","Errored, Not Charged","auto","No","692","0","126840","185","127717","0.03"
"2025-09-12T13:49:06.528Z","Included","auto","No","285285","162812","5216374","60517","5724988","1.83"
"2025-09-12T13:48:28.435Z","Errored, Not Charged","auto","No","16505","0","46141","2300","64946","0.04"
"2025-09-12T13:48:03.553Z","Included","auto","No","1305","0","247448","308","249061","0.06"
"2025-09-12T13:45:15.746Z","Errored, Not Charged","auto","No","14502","0","1239330","3891","1257723","0.34"
"2025-09-12T13:44:52.637Z","Errored, Not Charged","auto","No","1680","0","137370","103","139153","0.04"
"2025-09-12T13:44:15.274Z","Errored, Not Charged","auto","No","4067","0","129764","1494","135325","0.04"
"2025-09-12T13:44:02.493Z","Included","auto","No","133","0","44017","157","44307","0.01"
"2025-09-12T13:42:08.601Z","Errored, Not Charged","auto","No","32508","81338","49203","12395","175444","0.10"
"2025-09-12T13:41:03.630Z","Errored, Not Charged","auto","No","106974","0","342960","3231","453165","0.21"
"2025-09-12T13:38:28.129Z","Included","auto","No","1726","0","107521","133","109380","0.03"
"2025-09-12T13:37:01.454Z","Included","auto","No","1139","0","323713","196","325048","0.08"
"2025-09-12T13:36:34.962Z","Errored, Not Charged","auto","No","667","0","320742","115","321524","0.08"
"2025-09-12T13:36:18.568Z","Included","auto","No","793","0","124187","327","125307","0.03"
"2025-09-12T13:35:51.153Z","Included","auto","No","750","0","172014","205","172969","0.04"
"2025-09-12T13:34:27.252Z","Included","auto","No","567","0","319188","166","319921","0.08"
"2025-09-12T13:33:21.682Z","Included","auto","No","82329","0","235707","251","318287","0.14"
"2025-09-12T13:32:50.879Z","Included","auto","No","410","0","81862","114","82386","0.02"
"2025-09-12T13:32:39.595Z","Included","auto","No","1756","0","79757","129","81642","0.02"
"2025-09-12T13:32:22.388Z","Included","auto","No","1683","0","77973","231","79887","0.02"
"2025-09-12T13:31:49.893Z","Errored, Not Charged","auto","No","14894","0","100595","124","115613","0.04"
"2025-09-12T13:30:40.528Z","Included","auto","No","53675","0","117477","282","171434","0.08"
"2025-09-12T13:23:27.057Z","Included","auto","No","85593","0","1839861","4262","1929716","0.56"
"2025-09-12T13:18:54.242Z","Errored, Not Charged","auto","No","82954","835433","1122620","12654","2053661","0.54"
"2025-09-12T13:17:36.147Z","Included","auto","No","11291","0","497144","954","509389","0.14"
"2025-09-12T13:12:39.517Z","Included","auto","No","57882","0","990516","1821","1050219","0.31"
"2025-09-12T13:11:26.842Z","Errored, Not Charged","auto","No","23351","0","174354","279","197984","0.07"
"2025-09-12T13:11:05.248Z","Included","auto","No","60672","0","3837995","5996","3904663","1.04"
"2025-09-12T13:10:16.827Z","Errored, Not Charged","auto","No","25133","143834","34033","4604","207604","0.07"
"2025-09-12T13:08:54.766Z","Errored, Not Charged","auto","No","29493","0","737615","1800","768908","0.22"
"2025-09-12T13:08:22.402Z","Included","auto","No","22415","0","23836","310","46561","0.03"
"2025-09-12T12:51:20.744Z","Included","auto","No","91227","46374","3595569","26975","3760145","1.10"
"2025-09-12T12:48:53.008Z","Included","auto","No","30741","0","72076","40","102857","0.05"
"2025-09-12T12:48:26.770Z","Included","auto","No","4260","0","96963","1118","102341","0.03"
"2025-09-12T12:46:37.609Z","Errored, Not Charged","auto","No","13997","0","823238","7126","844361","0.25"
"2025-09-12T12:45:57.864Z","Errored, Not Charged","auto","No","505","0","82471","2660","85636","0.03"
"2025-09-12T12:45:27.978Z","Errored, Not Charged","auto","No","2480","0","486986","697","490163","0.13"
"2025-09-12T12:44:01.884Z","Errored, Not Charged","auto","No","7764","0","833085","4976","845825","0.24"
"2025-09-12T12:36:14.746Z","Errored, Not Charged","auto","No","96751","95005","1943191","35960","2170907","0.73"
"2025-09-12T12:33:47.327Z","Included","auto","No","2405","0","224356","1081","227842","0.06"
"2025-09-12T12:33:28.714Z","Errored, Not Charged","auto","No","986","0","333579","562","335127","0.09"
"2025-09-12T12:32:56.563Z","Included","auto","No","550","0","110148","521","111219","0.03"
"2025-09-12T12:32:22.265Z","Included","auto","No","669","0","109480","397","110546","0.03"
"2025-09-12T12:31:27.861Z","Included","auto","No","202","0","109279","505","109986","0.03"
"2025-09-12T12:25:28.680Z","Included","auto","No","501","0","217922","60","218483","0.06"
"2025-09-12T12:24:53.091Z","Included","auto","No","2449","0","169314","1438","173201","0.05"
"2025-09-12T12:23:22.670Z","Included","auto","No","1446","0","80773","1295","83514","0.03"
"2025-09-12T12:23:01.710Z","Included","auto","No","84946","0","132189","275","217410","0.12"
"2025-09-12T12:22:24.627Z","Included","auto","No","32918","0","86006","1354","120278","0.06"
"2025-09-12T12:11:39.576Z","Included","auto","No","99634","0","1405255","2875","1507764","0.46"
"2025-09-12T12:09:43.762Z","Included","auto","No","5532","0","173846","262","179640","0.05"
"2025-09-12T12:08:14.406Z","Included","auto","No","1098","0","347211","273","348582","0.09"
"2025-09-12T12:07:56.215Z","Errored, Not Charged","auto","No","481","0","172052","141","172674","0.04"
"2025-09-12T12:07:50.320Z","Included","auto","No","137","0","85766","112","86015","0.02"
"2025-09-12T12:07:04.788Z","Errored, Not Charged","auto","No","6735","0","745563","709","753007","0.20"
"2025-09-12T12:06:40.117Z","Included","auto","No","954","0","156289","182","157425","0.04"
"2025-09-12T12:03:23.839Z","Errored, Not Charged","auto","No","128335","0","1780343","7186","1915864","0.60"
"2025-09-12T12:02:45.716Z","Included","auto","No","56593","0","70111","1586","128290","0.08"
"2025-09-12T12:00:04.353Z","Included","auto","No","3109","0","609741","632","613482","0.16"
"2025-09-12T11:58:26.454Z","Included","auto","No","12496","0","8665","150","21311","0.02"
"2025-09-12T11:57:05.478Z","Errored, Not Charged","auto","No","13210","833887","7138","11617","865852","0.18"
"2025-09-12T11:56:44.657Z","Included","auto","No","67353","0","7159","210","74722","0.07"
"2025-09-12T11:55:13.863Z","Included","auto","No","3350","0","435659","688","439697","0.12"
"2025-09-12T11:54:54.345Z","Included","auto","No","65516","90692","7173","23080","186461","0.16"
"2025-09-12T11:52:06.269Z","Included","auto","No","6207","0","692484","1009","699700","0.18"
"2025-09-12T11:50:41.510Z","Included","auto","No","15996","0","370273","964","387233","0.11"
"2025-09-12T11:49:26.132Z","Errored, Not Charged","auto","No","28765","0","2698593","2604","2729962","0.71"
"2025-09-12T11:48:32.343Z","Errored, Not Charged","auto","No","3150","0","445671","420","449241","0.12"
"2025-09-12T11:47:19.811Z","Included","auto","No","138011","267442","2056671","41518","2503642","0.84"
"2025-09-12T11:44:50.122Z","Included","auto","No","12362","0","664851","1008","678221","0.18"
"2025-09-12T11:42:39.978Z","Errored, Not Charged","auto","No","36841","0","12834","175","49850","0.04"
"2025-09-12T11:37:45.584Z","Errored, Not Charged","auto","No","117537","0","1190920","1072","1309529","0.42"
"2025-09-12T11:36:42.512Z","Included","auto","No","319377","107313","2299193","26001","2751884","1.01"
"2025-09-12T11:36:40.290Z","Errored, Not Charged","auto","No","0","0","0","0","0","0.00"
"2025-09-12T11:35:00.256Z","Included","auto","No","62615","0","118857","686","182158","0.10"
"2025-09-12T11:32:13.491Z","Errored, Not Charged","auto","No","77056","0","757372","10937","845365","0.31"
"2025-09-12T11:30:36.840Z","Included","auto","No","188919","268874","2934551","45290","3437634","1.12"
"2025-09-12T11:27:08.554Z","Included","auto","No","57110","86838","497733","14393","656074","0.25"
"2025-09-12T11:25:11.009Z","Errored, Not Charged","auto","No","90270","0","385355","475","476100","0.19"
"2025-09-12T11:24:13.387Z","Included","auto","No","93485","83270","3894561","19981","4091297","1.15"
"2025-09-12T11:22:27.072Z","Errored, Not Charged","auto","No","2949","5912","612451","5473","626785","0.20"
"2025-09-12T11:21:13.513Z","Included","auto","No","2657","5736","422395","2591","433379","0.14"
"2025-09-12T11:20:42.023Z","Errored, Not Charged","auto","No","148914","17285","4330013","21015","4517227","1.31"
"2025-09-12T11:20:20.700Z","Included","auto","No","671","0","263938","132","264741","0.07"
"2025-09-12T11:20:03.294Z","Errored, Not Charged","auto","No","58538","0","203413","185","262136","0.11"
"2025-09-12T11:12:39.494Z","Included","auto","No","53964","0","29451","231","83646","0.06"
"2025-09-12T11:12:02.527Z","Included","auto","No","1976","0","276712","478","279166","0.07"
"2025-09-12T11:08:33.817Z","Included","auto","No","84664","0","638896","1191","724751","0.25"
"2025-09-12T11:06:42.692Z","Included","auto","No","3209","0","648772","1086","653067","0.17"
"2025-09-12T11:06:32.945Z","Errored, Not Charged","auto","No","613","0","78569","259","79441","0.02"
"2025-09-12T11:01:01.891Z","Errored, Not Charged","auto","No","37499","0","1294424","1574","1333497","0.37"
"2025-09-12T10:59:21.488Z","Errored, Not Charged","auto","No","16219","0","510938","1715","528872","0.15"
"2025-09-12T10:56:52.189Z","Errored, Not Charged","auto","No","21412","101641","290445","12258","425756","0.15"
"2025-09-12T10:54:48.711Z","Included","auto","No","3635","0","345662","1599","350896","0.10"
"2025-09-12T10:53:46.914Z","Errored, Not Charged","auto","No","9540","0","3526564","3540","3539644","0.91"
"2025-09-12T10:53:35.511Z","Included","auto","No","428","0","102303","410","103141","0.03"
"2025-09-12T10:52:17.864Z","Errored, Not Charged","auto","No","5419","0","1598605","1911","1605935","0.41"
"2025-09-12T10:51:45.126Z","Included","auto","No","730","0","96118","603","97451","0.03"
"2025-09-12T10:51:23.913Z","Errored, Not Charged","auto","No","3005","0","284361","635","288001","0.08"
"2025-09-12T10:50:04.992Z","Included","auto","No","7991","0","1554829","2169","1564989","0.41"
"2025-09-12T10:48:45.337Z","Included","auto","No","2874","0","532456","1432","536762","0.14"
"2025-09-12T10:47:58.823Z","Included","auto","No","219","0","74897","533","75649","0.02"
"2025-09-12T10:47:30.842Z","Included","auto","No","6023","0","138227","277","144527","0.04"
"2025-09-12T10:44:47.223Z","Included","auto","No","18339","0","1813561","1763","1833663","0.48"
"2025-09-12T10:44:15.558Z","Included","auto","No","76991","74910","683015","13312","848228","0.31"
"2025-09-12T10:44:05.534Z","Included","auto","No","493","0","90113","354","90960","0.02"
"2025-09-12T10:43:27.714Z","Included","auto","No","60948","0","29166","359","90473","0.07"
"2025-09-12T10:43:15.064Z","Included","auto","No","0","0","0","0","0","0.00"
"2025-09-12T10:41:55.788Z","Included","auto","No","20505","0","1764900","5463","1790868","0.48"
"2025-09-12T10:41:54.833Z","Included","auto","No","12999","0","1377035","2841","1392875","0.37"
"2025-09-12T10:40:52.721Z","Included","auto","No","9825","0","196995","1995","208815","0.07"
"2025-09-12T10:38:12.756Z","Included","auto","No","69514","105567","665586","10991","851658","0.29"
"2025-09-12T10:37:49.975Z","Errored, Not Charged","auto","No","179874","61466","1143406","22401","1407147","0.57"
"2025-09-12T10:33:36.530Z","Included","auto","No","147826","81","4195263","3905","4347075","1.75"
"2025-09-12T10:32:24.468Z","Errored, Not Charged","auto","No","1256","1784","136557","504","140101","0.04"
"2025-09-12T10:30:11.752Z","Errored, Not Charged","auto","No","14875","0","1656688","3098","1674661","0.44"
"2025-09-12T10:27:11.199Z","Included","auto","No","8186","0","2785956","2369","2796511","0.71"
"2025-09-12T10:25:45.095Z","Included","auto","No","2155","4806","207688","2310","216959","0.08"
"2025-09-12T10:23:32.572Z","Included","auto","No","43752","4608","156765","2402","207527","0.11"
"2025-09-12T10:22:07.300Z","Included","auto","No","704","0","197579","294","198577","0.05"
"2025-09-12T10:21:47.379Z","Errored, Not Charged","auto","No","441","0","294807","269","295517","0.08"
"2025-09-12T10:20:32.895Z","Errored, Not Charged","auto","No","10029","0","87883","157","98069","0.03"
"2025-09-12T10:15:52.711Z","Included","auto","No","9560","0","1006211","1438","1017209","0.27"
"2025-09-12T10:10:01.536Z","Errored, Not Charged","auto","No","22720","0","756164","373","779257","0.21"
"2025-09-12T10:08:40.644Z","Included","auto","No","1644","0","252013","517","254174","0.07"
"2025-09-12T10:06:55.210Z","Errored, Not Charged","auto","No","4092","0","1059789","1096","1064977","0.27"
"2025-09-12T10:05:30.112Z","Errored, Not Charged","auto","No","10683","0","859256","1026","870965","0.23"
"2025-09-12T10:04:46.731Z","Errored, Not Charged","auto","No","3794","0","533426","617","537837","0.14"
"2025-09-12T10:03:20.552Z","Errored, Not Charged","auto","No","9462","0","483564","571","493597","0.13"
"2025-09-12T09:49:36.397Z","Included","auto","No","40517","0","260209","1807","302533","0.11"
"2025-09-12T09:45:55.174Z","Included","auto","No","55140","102334","3541826","16041","3715341","1.01"
"2025-09-12T09:43:43.033Z","Included","auto","No","128","0","105762","228","106118","0.03"
"2025-09-12T09:42:48.839Z","Errored, Not Charged","auto","No","14488","0","195932","418","210838","0.07"
"2025-09-12T09:34:58.265Z","Errored, Not Charged","auto","No","183412","98825","2600295","23362","2905894","0.93"
"2025-09-12T09:33:34.867Z","Included","auto","No","401","0","39170","62","39633","0.01"
"2025-09-12T09:31:21.464Z","Included","auto","No","44345","0","660841","1254","706440","0.21"
"2025-09-12T09:31:00.043Z","Included","auto","No","4871","0","100657","98","105626","0.03"
"2025-09-12T09:27:53.312Z","Errored, Not Charged","auto","No","46251","0","1088330","3522","1138103","0.33"
"2025-09-12T09:27:25.966Z","Errored, Not Charged","auto","No","2314","0","318833","546","321693","0.08"
"2025-09-12T09:27:14.774Z","Errored, Not Charged","auto","No","6073","0","95422","140","101635","0.03"
"2025-09-12T09:22:47.720Z","Included","auto","No","3277","0","517368","1033","521678","0.14"
"2025-09-12T09:21:34.328Z","Errored, Not Charged","auto","No","14251","3204","474153","1435","493043","0.15"
"2025-09-12T09:20:44.318Z","Included","auto","No","2099","0","247897","718","250714","0.07"
"2025-09-12T09:20:10.576Z","Errored, Not Charged","auto","No","1143","0","197317","301","198761","0.05"
"2025-09-12T09:18:59.784Z","Errored, Not Charged","auto","No","6470","3258","444923","1931","456582","0.14"
"2025-09-12T09:18:36.028Z","Errored, Not Charged","auto","No","897","0","158707","378","159982","0.04"
"2025-09-12T09:17:44.345Z","Errored, Not Charged","auto","No","4655","0","88008","154","92817","0.03"
"2025-09-12T09:12:20.772Z","Included","auto","No","3929","0","335617","1446","340992","0.09"
"2025-09-12T09:10:48.460Z","Errored, Not Charged","auto","No","17777","809988","8508","7567","843840","0.17"
"2025-09-12T09:09:01.421Z","Included","auto","No","108809","0","1195107","2170","1306086","0.42"
"2025-09-12T09:08:33.347Z","Included","auto","No","33392","0","7138","285","40815","0.04"
"2025-09-12T09:05:50.188Z","Included","auto","No","9194","656","642884","1607","654341","0.18"
"2025-09-12T09:02:14.763Z","Errored, Not Charged","auto","No","14484","768","441281","2001","458534","0.14"
"2025-09-12T09:01:15.531Z","Errored, Not Charged","auto","No","25315","0","163382","391","189088","0.07"
"2025-09-12T09:00:42.393Z","Errored, Not Charged","auto","No","58339","0","50034","73","108446","0.07"
"2025-09-12T08:57:18.673Z","Included","auto","No","48365","579369","519337","11243","1158314","0.31"
"2025-09-12T08:53:31.974Z","Included","auto","No","13730","0","1065740","1211","1080681","0.29"
"2025-09-12T08:53:16.776Z","Included","auto","No","30586","98417","803914","13830","946747","0.30"
"2025-09-12T08:48:38.522Z","Errored, Not Charged","auto","No","16846","0","702328","2842","722016","0.20"
"2025-09-12T08:48:17.865Z","Errored, Not Charged","auto","No","267","0","130622","88","130977","0.03"
"2025-09-12T08:47:15.976Z","Errored, Not Charged","auto","No","107972","0","870477","890","979339","0.33"
"2025-09-12T08:47:15.224Z","Errored, Not Charged","auto","No","5819","0","200833","224","206876","0.06"
"2025-09-12T08:47:09.936Z","Included","auto","No","60013","0","749752","1299","811064","0.25"
"2025-09-12T08:45:18.124Z","Errored, Not Charged","auto","No","42716","793410","7138","9795","853059","0.20"
"2025-09-12T08:38:38.182Z","Errored, Not Charged","auto","No","97758","0","111304","121","209183","0.13"
"2025-09-12T08:33:54.401Z","Included","auto","No","155813","107402","828352","34192","1125759","0.51"
"2025-09-12T08:32:42.008Z","Included","auto","No","1003","0","206883","243","208129","0.05"
"2025-09-12T08:31:45.901Z","Included","auto","No","75923","0","840069","1966","917958","0.29"
"2025-09-12T08:31:32.810Z","Included","auto","No","755","0","206036","269","207060","0.05"
"2025-09-12T08:29:00.795Z","Errored, Not Charged","auto","No","775","0","307118","212","308105","0.08"
"2025-09-12T08:26:19.517Z","Errored, Not Charged","auto","No","33951","112479","587065","11036","744531","0.24"
"2025-09-12T08:25:44.336Z","Included","auto","No","16371","0","2009744","5086","2031201","0.54"
"2025-09-12T08:23:53.585Z","Errored, Not Charged","auto","No","95384","777916","8508","6298","888106","0.24"
"2025-09-12T08:21:53.999Z","Included","auto","No","2954","0","517481","1403","521838","0.14"
"2025-09-12T08:20:31.391Z","Included","auto","No","4501","0","253815","195","258511","0.07"
"2025-09-12T08:18:42.184Z","Errored, Not Charged","auto","No","53143","5360","593613","5686","657802","0.24"
"2025-09-12T08:10:53.824Z","Errored, Not Charged","auto","No","78127","68709","1297637","12549","1457022","0.46"
"2025-09-12T08:05:14.029Z","Included","auto","No","177305","0","4961382","10931","5149618","1.46"
"2025-09-12T08:03:42.322Z","Included","auto","No","14293","0","380473","4125","398891","0.13"
"2025-09-12T08:01:32.842Z","Included","auto","No","507","0","41834","978","43319","0.01"
"2025-09-12T08:00:37.249Z","Errored, Not Charged","auto","No","31912","101966","265223","13121","412222","0.16"
"2025-09-12T07:58:29.483Z","Included","auto","No","34811","0","1561849","3528","1600188","0.44"
"2025-09-12T07:57:48.665Z","Errored, Not Charged","auto","No","26864","0","369835","1576","398275","0.13"
"2025-09-12T07:56:55.441Z","Included","auto","No","14491","0","1072978","860","1088329","0.29"
"2025-09-12T07:54:47.270Z","Included","auto","No","41573","91176","3226498","7795","3367042","0.89"
"2025-09-12T07:53:35.015Z","Included","auto","No","1843","0","569448","671","571962","0.15"
"2025-09-12T07:53:10.261Z","Errored, Not Charged","auto","No","888","0","478583","259","479730","0.12"
"2025-09-12T07:52:47.630Z","Errored, Not Charged","auto","No","136","0","94858","65","95059","0.02"
"2025-09-12T07:50:21.324Z","Errored, Not Charged","auto","No","39332","0","1051391","747","1091470","0.31"
"2025-09-12T07:47:44.082Z","Included","auto","No","31337","0","357467","351","389155","0.12"
"2025-09-12T07:47:36.986Z","Errored, Not Charged","auto","No","655","0","112228","187","113070","0.03"
"2025-09-12T07:46:53.089Z","Errored, Not Charged","auto","No","1525","0","386453","327","388305","0.10"
"2025-09-12T07:44:21.980Z","Errored, Not Charged","auto","No","329211","0","3256690","17302","3603203","1.21"
"2025-09-12T07:43:36.093Z","Errored, Not Charged","auto","No","24371","0","345842","1474","371687","0.12"
"2025-09-12T07:43:08.485Z","Included","auto","No","91730","45117","4172607","18472","4327926","1.21"
"2025-09-12T07:40:09.578Z","Included","auto","No","86285","0","1155104","3079","1244468","0.39"
"2025-09-12T07:38:48.846Z","Included","auto","No","82989","0","1087447","2118","1172554","0.36"
"2025-09-12T07:37:31.607Z","Errored, Not Charged","auto","No","2768","0","423477","751","426996","0.11"
"2025-09-12T07:31:52.011Z","Included","auto","No","26769","0","599718","2547","629034","0.19"
"2025-09-12T07:31:19.438Z","Errored, Not Charged","auto","No","80701","0","1964621","8259","2053581","0.60"
"2025-09-12T07:31:00.311Z","Included","auto","No","26363","0","1018977","1661","1047001","0.29"
"2025-09-12T07:29:24.396Z","Included","auto","No","20706","203520","17506","6001","247733","0.08"
"2025-09-12T07:27:28.328Z","Included","auto","No","19379","0","1776283","10371","1806033","0.50"
"2025-09-12T07:26:45.520Z","Errored, Not Charged","auto","No","4070","0","303761","2572","310403","0.09"
"2025-09-12T07:26:01.877Z","Included","auto","No","11319","0","834079","1406","846804","0.23"
"2025-09-12T07:25:38.274Z","Errored, Not Charged","auto","No","51064","0","221154","5407","277625","0.13"
"2025-09-12T07:23:51.225Z","Errored, Not Charged","auto","No","7241","0","244191","533","251965","0.07"
"2025-09-12T07:22:48.718Z","Errored, Not Charged","auto","No","11597","0","342850","1355","355802","0.10"
"2025-09-12T07:22:36.362Z","Errored, Not Charged","auto","No","25088","0","40344","103","65535","0.04"
"2025-09-12T07:18:19.047Z","Errored, Not Charged","auto","No","58712","0","2146046","6924","2211682","0.62"
"2025-09-12T07:17:01.945Z","Errored, Not Charged","auto","No","10262","0","576013","331","586606","0.16"
"2025-09-12T07:14:43.846Z","Errored, Not Charged","auto","No","11642","0","702482","539","714663","0.19"
"2025-09-12T07:12:11.805Z","Included","auto","No","1113","0","331548","450","333111","0.09"
"2025-09-12T07:11:44.177Z","Included","auto","No","659","0","329971","345","330975","0.08"
"2025-09-12T07:11:36.379Z","Errored, Not Charged","auto","No","497","0","109220","61","109778","0.03"
"2025-09-12T07:10:14.818Z","Included","auto","No","20304","0","874942","901","896147","0.24"
"2025-09-12T07:06:21.676Z","Included","auto","No","81804","0","514136","1199","597139","0.22"
"2025-09-12T07:05:44.116Z","Included","auto","No","64526","383378","697344","23165","1168413","0.38"
"2025-09-12T07:03:49.379Z","Included","auto","No","90395","0","1778817","5458","1874670","0.56"
"2025-09-12T07:03:02.253Z","Included","auto","No","100721","0","2367418","3324","2471463","0.71"
"2025-09-12T07:01:16.019Z","Errored, Not Charged","auto","No","9787","0","853341","4653","867781","0.24"
"2025-09-12T07:00:27.323Z","Included","auto","No","3454","0","85674","901","90029","0.03"
"2025-09-12T06:53:08.597Z","Included","auto","No","82835","0","334431","1425","418691","0.17"
"2025-09-12T06:51:53.794Z","Errored, Not Charged","auto","No","519","0","108534","196","109249","0.03"
"2025-09-12T06:50:02.336Z","Included","auto","No","78555","318665","1426386","9921","1833527","0.52"
"2025-09-12T06:48:36.976Z","Included","auto","No","218164","142620","3825973","40883","4227640","1.34"
"2025-09-12T06:46:55.656Z","Included","auto","No","14674","0","485170","698","500542","0.14"
"2025-09-12T06:46:16.543Z","Included","auto","No","382","0","93484","159","94025","0.02"
"2025-09-12T06:45:52.598Z","Included","auto","No","329","0","93288","116","93733","0.02"
"2025-09-12T06:44:21.026Z","Included","auto","No","17988","0","450012","1237","469237","0.14"
"2025-09-12T06:42:45.592Z","Errored, Not Charged","auto","No","57359","0","993405","893","1051657","0.31"
"2025-09-12T06:42:25.412Z","Included","auto","No","1335","0","62842","154","64331","0.02"
"2025-09-12T06:39:52.497Z","Included","auto","No","18513","0","513483","2911","534907","0.16"
"2025-09-12T06:38:15.524Z","Errored, Not Charged","auto","No","377337","0","3690836","8609","4076782","1.33"
"2025-09-12T06:35:07.367Z","Errored, Not Charged","auto","No","25627","0","2332323","3860","2361810","0.62"
"2025-09-12T06:34:39.182Z","Errored, Not Charged","auto","No","16857","0","436575","1018","454450","0.13"
"2025-09-12T06:34:04.496Z","Errored, Not Charged","auto","No","403","0","22213","64","22680","0.01"
"2025-09-12T06:31:18.906Z","Included","auto","No","151151","0","2809639","13738","2974528","0.91"
"2025-09-12T06:29:12.182Z","Included","auto","No","11953","96326","95299","6528","210106","0.07"
"2025-09-12T06:28:16.875Z","Included","auto","No","3596","3543","242280","2852","252271","0.10"
"2025-09-12T06:26:37.878Z","Included","auto","No","3782","5565","340532","4128","354007","0.14"
"2025-09-12T06:26:08.379Z","Included","auto","No","494","0","165045","362","165901","0.04"
"2025-09-12T06:25:04.334Z","Errored, Not Charged","auto","No","216768","174103","4571581","44428","5006880","1.55"
"2025-09-12T06:23:40.180Z","Errored, Not Charged","auto","No","1086","0","285127","549","286762","0.07"
"2025-09-12T06:23:30.789Z","Included","auto","No","4391","0","429437","465","434293","0.11"
"2025-09-12T06:23:00.092Z","Included","auto","No","11322","0","177870","362","189554","0.06"
"2025-09-12T06:22:22.347Z","Included","auto","No","1317","0","53504","78","54899","0.02"
"2025-09-12T06:21:28.186Z","Included","auto","No","1770","0","214133","396","216299","0.06"
"2025-09-12T06:20:46.920Z","Errored, Not Charged","auto","No","27010","0","3889617","4985","3921612","1.02"
"2025-09-12T06:20:09.036Z","Errored, Not Charged","auto","No","2591","0","76571","64","79226","0.02"
"2025-09-12T06:18:12.659Z","Included","auto","No","45931","0","1428560","8709","1483200","0.44"
"2025-09-12T06:17:20.298Z","Included","auto","No","2281","1258","385603","1787","390929","0.11"
"2025-09-12T06:17:10.509Z","Errored, Not Charged","auto","No","861","0","227729","145","228735","0.06"
"2025-09-12T06:15:51.176Z","Errored, Not Charged","auto","No","88816","0","171187","259","260262","0.13"
"2025-09-12T06:15:31.861Z","Included","auto","No","16723","0","1401148","4899","1422770","0.39"
"2025-09-12T06:13:55.775Z","Errored, Not Charged","auto","No","1911","0","312031","4669","318611","0.10"
"2025-09-12T06:11:26.530Z","Included","auto","No","44574","0","1041391","2084","1088049","0.31"
"2025-09-12T06:10:03.054Z","Errored, Not Charged","auto","No","20203","0","927538","12100","959841","0.30"
"2025-09-12T06:08:33.403Z","Errored, Not Charged","auto","No","4450","2421","231609","4944","243424","0.10"
"2025-09-12T06:07:28.956Z","Included","auto","No","32712","0","1665514","1525","1699751","0.46"
"2025-09-12T06:06:54.635Z","Included","auto","No","711","0","79320","13","80044","0.02"
"2025-09-12T06:05:16.081Z","Included","auto","No","26683","94144","268188","11535","400550","0.17"
"2025-09-12T06:03:04.479Z","Included","auto","No","11959","4839","1674894","5862","1697554","0.47"
"2025-09-12T06:02:41.857Z","Included","auto","No","62171","90025","2499207","14288","2665691","0.76"
"2025-09-12T06:01:58.614Z","Errored, Not Charged","auto","No","27887","0","1814546","7920","1850353","0.51"
"2025-09-12T06:01:39.059Z","Included","auto","No","1307","0","202450","137","203894","0.05"
"2025-09-12T06:01:36.790Z","Included","auto","No","225","0","49935","13","50173","0.01"
"2025-09-12T06:01:24.769Z","Errored, Not Charged","auto","No","0","0","0","0","0","0.00"
"2025-09-12T06:01:07.418Z","Errored, Not Charged","auto","No","6120","0","704640","306","711066","0.18"
"2025-09-12T05:59:20.556Z","Included","auto","No","1870","0","189662","2548","194080","0.06"
"2025-09-12T05:57:44.077Z","Errored, Not Charged","auto","No","4149","0","621421","867","626437","0.16"
"2025-09-12T05:56:21.983Z","Included","auto","No","7491","0","1334141","2991","1344623","0.35"
"2025-09-12T05:55:59.352Z","Included","auto","No","499","0","90999","271","91769","0.02"
"2025-09-12T05:55:43.398Z","Included","auto","No","67242","0","23758","355","91355","0.07"
"2025-09-12T05:54:56.964Z","Included","auto","No","882","0","89535","438","90855","0.03"
"2025-09-12T05:53:56.890Z","Errored, Not Charged","auto","No","11076","0","934259","2738","948073","0.26"
"2025-09-12T05:52:26.627Z","Errored, Not Charged","auto","No","15951","3012","672534","4073","695570","0.22"
"2025-09-12T05:51:16.632Z","Included","auto","No","66088","0","2559585","8253","2633926","0.74"
"2025-09-12T05:49:57.475Z","Included","auto","No","18054","0","165670","903","184627","0.06"
"2025-09-12T05:48:22.974Z","Errored, Not Charged","auto","No","38795","0","1055628","7530","1101953","0.33"
"2025-09-12T05:47:28.222Z","Included","auto","No","15475","0","872854","6120","894449","0.26"
"2025-09-12T05:46:32.565Z","Errored, Not Charged","auto","No","13068","109350","10356","13193","145967","0.08"
"2025-09-12T05:45:47.153Z","Included","auto","No","0","0","0","0","0","0.00"
"2025-09-12T05:45:32.945Z","Errored, Not Charged","auto","No","0","0","0","0","0","0.00"
"2025-09-12T05:44:36.877Z","Included","auto","No","36381","106321","206064","15334","364100","0.16"
"2025-09-12T05:42:57.845Z","Errored, Not Charged","auto","No","110623","2478","2054721","7668","2175490","0.67"
"2025-09-12T05:41:56.565Z","Included","auto","No","204883","114175","20730","5973","345761","0.25"
"2025-09-12T05:41:28.921Z","Errored, Not Charged","auto","No","18558","0","2789111","2183","2809852","0.72"
"2025-09-12T05:39:33.332Z","Included","auto","No","1087","0","188553","231","189871","0.05"
"2025-09-12T05:38:16.001Z","Included","auto","No","86851","0","832497","1003","920351","0.30"
"2025-09-12T05:36:32.525Z","Included","auto","No","29402","2090","1830084","16965","1878541","0.56"
"2025-09-12T05:35:36.287Z","Included","auto","No","49432","0","215706","1282","266420","0.11"
"2025-09-12T05:35:18.841Z","Errored, Not Charged","auto","No","12792","0","1558102","2797","1573691","0.41"
"2025-09-12T05:35:07.414Z","Errored, Not Charged","auto","No","7800","0","162933","159","170892","0.05"
"2025-09-12T05:31:39.596Z","Included","auto","No","187953","0","2572440","11824","2772217","0.88"
"2025-09-12T05:31:14.278Z","Errored, Not Charged","auto","No","1392","0","33910","61","35363","0.01"
"2025-09-12T05:30:21.541Z","Included","auto","No","44971","112507","385537","16439","559454","0.22"
"2025-09-12T05:29:19.698Z","Included","auto","No","71094","0","1996997","4815","2072906","0.59"
"2025-09-12T05:28:36.064Z","Errored, Not Charged","auto","No","2458","0","77842","4000","84300","0.04"
"2025-09-12T05:27:32.900Z","Errored, Not Charged","auto","No","12883","0","180528","5018","198429","0.08"
"2025-09-12T05:26:20.724Z","Included","auto","No","347","0","24542","64","24953","0.01"
"2025-09-12T05:23:46.150Z","Included","auto","No","14192","25164","81191","4621","125168","0.05"
"2025-09-12T05:23:24.218Z","Included","auto","No","58984","86419","1567145","9842","1722390","0.50"
"2025-09-12T05:22:34.419Z","Included","auto","No","39738","0","1695542","3248","1738528","0.48"
"2025-09-12T05:22:13.165Z","Included","auto","No","445","0","104923","294","105662","0.03"
"2025-09-12T05:22:03.581Z","Included","auto","No","821","0","104103","295","105219","0.03"
"2025-09-12T05:21:56.688Z","Errored, Not Charged","auto","No","324","0","103780","87","104191","0.03"
"2025-09-12T05:21:48.958Z","Errored, Not Charged","auto","No","1926","0","101855","139","103920","0.03"
"2025-09-12T05:21:41.879Z","Errored, Not Charged","auto","No","290","0","101566","91","101947","0.03"
"2025-09-12T05:21:34.602Z","Errored, Not Charged","auto","No","297","0","101270","99","101666","0.03"
"2025-09-12T05:21:15.264Z","Errored, Not Charged","auto","No","16429","0","945857","2476","964762","0.26"
"2025-09-12T05:18:56.060Z","Errored, Not Charged","auto","No","13498","2048","609325","1579","626450","0.18"
"2025-09-12T05:16:34.752Z","Included","auto","No","18035","0","592152","845","611032","0.17"
"2025-09-12T05:15:27.156Z","Errored, Not Charged","auto","No","59474","0","673180","2444","735098","0.24"
"2025-09-12T05:10:03.712Z","Included","auto","No","41631","0","113391","468","155490","0.07"
"2025-09-12T05:08:09.593Z","Included","auto","No","197554","0","3031800","10456","3239810","1.00"
"2025-09-12T05:07:30.567Z","Errored, Not Charged","auto","No","2119","0","81596","3852","87567","0.04"
"2025-09-12T05:06:40.223Z","Included","auto","No","1758","0","24794","236","26788","0.01"
"2025-09-12T05:05:51.750Z","Errored, Not Charged","auto","No","17510","0","7285","81","24876","0.02"
"2025-09-12T05:05:20.209Z","Included","auto","No","37611","0","2029974","23088","2090673","0.64"
"2025-09-12T05:04:48.794Z","Errored, Not Charged","auto","No","20479","0","79484","376","100339","0.04"
"2025-09-12T05:04:19.787Z","Included","auto","No","1522","0","56917","214","58653","0.02"
"2025-09-12T05:04:01.702Z","Included","auto","No","445","0","37545","97","38087","0.01"
"2025-09-12T05:03:46.736Z","Errored, Not Charged","auto","No","2158","0","53295","150","55603","0.02"
"2025-09-12T05:03:37.090Z","Errored, Not Charged","auto","No","631","0","32062","144","32837","0.01"
"2025-09-12T05:02:26.485Z","Included","auto","No","3591","0","148605","1409","153605","0.05"
"2025-09-12T05:02:05.671Z","Included","auto","No","5135","0","17537","301","22973","0.01"
"2025-09-12T05:01:54.299Z","Included","auto","No","39703","0","920786","4577","965066","0.29"
"2025-09-12T05:01:16.298Z","Included","auto","No","17139","112","441118","3422","461791","0.14"
"2025-09-12T04:52:47.851Z","Included","auto","No","12203","0","1679216","2695","1694114","0.44"
"2025-09-12T04:52:12.550Z","Included","auto","No","14621","0","278613","10592","303826","0.13"
"2025-09-12T04:50:26.131Z","Included","auto","No","6140","0","448379","1034","455553","0.12"
"2025-09-12T04:49:41.349Z","Included","auto","No","2467","0","343807","1218","347492","0.09"
"2025-09-12T04:48:57.851Z","Errored, Not Charged","auto","No","2898","0","173287","6954","183139","0.07"
"2025-09-12T04:48:06.289Z","Included","auto","No","9590","0","481913","562","492065","0.13"
"2025-09-12T04:47:32.624Z","Errored, Not Charged","auto","No","6606","0","214250","119","220975","0.06"
"2025-09-12T04:46:25.424Z","Included","auto","No","762","0","139375","223","140360","0.04"
"2025-09-12T04:45:54.134Z","Errored, Not Charged","auto","No","28174","86675","785982","16169","917000","0.30"
"2025-09-12T04:44:22.729Z","Included","auto","No","1364","0","273944","707","276015","0.07"
"2025-09-12T04:44:05.495Z","Included","auto","No","643","0","67537","156","68336","0.02"
"2025-09-12T04:42:18.849Z","Included","auto","No","41628","85722","559845","5004","692199","0.21"
"2025-09-12T04:41:15.806Z","Included","auto","No","451","0","203014","230","203695","0.05"
"2025-09-12T04:38:12.293Z","Included","auto","No","8769","0","2762897","2759","2774425","0.71"
"2025-09-12T04:34:49.962Z","Included","auto","No","21795","0","1935920","3938","1961653","0.52"
"2025-09-12T04:32:56.767Z","Errored, Not Charged","auto","No","12574","0","528813","1544","542931","0.15"
"2025-09-12T04:30:44.568Z","Errored, Not Charged","auto","No","60251","0","473675","415","534341","0.18"
"2025-09-12T04:28:19.498Z","Included","auto","No","74835","0","165244","1286","241365","0.12"
"2025-09-12T04:28:04.503Z","Included","auto","No","42398","0","36367","454","79219","0.05"
"2025-09-12T04:26:24.726Z","Errored, Not Charged","auto","No","181199","0","4594237","21219","4796655","1.41"
"2025-09-12T04:26:20.650Z","Errored, Not Charged","auto","No","364","0","57711","74","58149","0.02"
"2025-09-12T04:26:16.661Z","Errored, Not Charged","auto","No","985","0","56727","80","57792","0.02"
"2025-09-12T04:25:30.381Z","Errored, Not Charged","auto","No","1559","0","389452","306","391317","0.10"
"2025-09-12T04:24:39.728Z","Included","auto","No","18804","0","1161784","3953","1184541","0.33"
"2025-09-12T04:23:10.049Z","Errored, Not Charged","auto","No","7821","0","1015573","1356","1024750","0.27"
"2025-09-12T04:23:02.352Z","Errored, Not Charged","auto","No","4117","0","142114","160","146391","0.04"
"2025-09-12T04:22:13.738Z","Errored, Not Charged","auto","No","3346","1275","343557","3268","351446","0.11"
"2025-09-12T04:21:42.515Z","Included","auto","No","220","0","41254","158","41632","0.01"
"2025-09-12T04:21:08.676Z","Errored, Not Charged","auto","No","73321","70657","1936923","13937","2094838","0.62"
"2025-09-12T04:19:53.830Z","Included","auto","No","7775","0","521649","2899","532323","0.15"
"2025-09-12T04:18:54.820Z","Errored, Not Charged","auto","No","19033","0","2138960","5712","2163705","0.58"
"2025-09-12T04:17:21.010Z","Included","auto","No","664","0","74658","92","75414","0.02"
"2025-09-12T04:16:28.906Z","Included","auto","No","24990","99102","424358","8129","556579","0.18"
"2025-09-12T04:16:14.890Z","Included","auto","No","3724","0","746337","1304","751365","0.20"
"2025-09-12T04:15:55.031Z","Included","auto","No","178","0","74935","71","75184","0.02"
"2025-09-12T04:15:51.602Z","Included","auto","No","150","0","74786","52","74988","0.02"
"2025-09-12T04:15:47.882Z","Included","auto","No","610","0","74177","20","74807","0.02"
"2025-09-12T04:15:31.558Z","Errored, Not Charged","auto","No","7443","0","355746","323","363512","0.10"
"2025-09-12T04:15:06.972Z","Included","auto","No","3935","0","410019","401","414355","0.11"
"2025-09-12T04:13:52.675Z","Included","auto","No","6397","0","846470","1056","853923","0.22"
"2025-09-12T04:12:28.916Z","Errored, Not Charged","auto","No","15515","0","1099126","930","1115571","0.29"
"2025-09-12T04:10:00.823Z","Errored, Not Charged","auto","No","16437","0","1270244","1098","1287779","0.34"
"2025-09-12T04:09:21.763Z","Errored, Not Charged","auto","No","59238","0","395095","976","455309","0.16"
"2025-09-12T04:07:12.183Z","Errored, Not Charged","auto","No","21237","6122","1131513","2063","1160935","0.33"
"2025-09-12T04:03:09.877Z","Included","auto","No","7419","0","585375","1416","594210","0.16"
"2025-09-12T03:59:35.325Z","Included","auto","No","5376","0","555377","1375","562128","0.15"
"2025-09-12T03:58:39.627Z","Included","auto","No","399","0","106264","142","106805","0.03"
"2025-09-12T03:58:21.421Z","Included","auto","No","7065","0","98799","91","105955","0.03"
"2025-09-12T03:56:54.181Z","Included","auto","No","111279","8212","3799820","7204","3926515","1.57"
"2025-09-12T03:56:02.843Z","Included","auto","No","6322","0","98098","197","104617","0.03"
"2025-09-12T03:53:16.493Z","Included","auto","No","4402","0","841236","1023","846661","0.22"
"2025-09-12T03:52:31.326Z","Included","auto","No","42945","0","600336","2611","645892","0.20"
"2025-09-12T03:50:49.919Z","Included","auto","No","44696","8816","213011","3426","269949","0.15"
"2025-09-12T03:50:06.724Z","Included","auto","No","13569","0","487264","3926","504759","0.15"
"2025-09-12T03:47:15.556Z","Included","auto","No","3807","0","350363","1822","355992","0.10"
"2025-09-12T03:46:58.837Z","Errored, Not Charged","auto","No","403","0","32432","120","32955","0.01"
"2025-09-12T03:45:14.571Z","Included","auto","No","6744","0","224365","2899","234008","0.07"
"2025-09-12T03:43:44.940Z","Included","auto","No","17297","70291","8400","5757","101745","0.05"
"2025-09-12T03:41:40.659Z","Included","auto","No","8394","0","1752487","3219","1764100","0.46"
"2025-09-12T03:41:10.125Z","Errored, Not Charged","auto","No","16020","0","178196","564","194780","0.06"
"2025-09-12T03:38:44.138Z","Included","auto","No","18600","0","2123884","4166","2146650","0.57"
"2025-09-12T03:37:36.484Z","Included","auto","No","28496","0","1033575","3717","1065788","0.30"
"2025-09-12T03:36:57.203Z","Errored, Not Charged","auto","No","15881","248438","7282","4417","276018","0.07"
"2025-09-12T03:35:48.448Z","Included","auto","No","28557","0","919764","1274","949595","0.26"
"2025-09-12T03:34:39.364Z","Included","auto","No","22649","0","519756","1721","544126","0.16"
"2025-09-12T03:33:34.143Z","Included","auto","No","12998","100809","7138","4402","125347","0.05"
"2025-09-12T03:33:17.494Z","Included","auto","No","82300","0","873156","1298","956754","0.31"
"2025-09-12T03:32:16.151Z","Errored, Not Charged","auto","No","4899","5590","966850","2968","980307","0.28"
"2025-09-12T03:31:32.574Z","Included","auto","No","0","0","0","0","0","0.00"
"2025-09-12T03:31:27.811Z","Errored, Not Charged","auto","No","98119","2770","214349","1228","316466","0.17"
"2025-09-12T03:30:02.136Z","Included","auto","No","1939","0","476915","585","479439","0.12"
"2025-09-12T03:28:35.901Z","Included","auto","No","71772","0","546462","523","618757","0.21"
"2025-09-12T03:28:20.361Z","Included","auto","No","1086","0","150499","146","151731","0.04"
"2025-09-12T03:26:38.953Z","Included","auto","No","1429","0","444383","617","446429","0.11"
"2025-09-12T03:26:22.389Z","Included","auto","No","5315","2525","1198636","1982","1208458","0.32"
"2025-09-12T03:26:16.091Z","Included","auto","No","294","0","146756","83","147133","0.04"
"2025-09-12T03:25:22.506Z","Included","auto","No","2250","0","358880","425","361555","0.09"
"2025-09-12T03:24:31.354Z","Errored, Not Charged","auto","No","558","0","96877","121","97556","0.03"
"2025-09-12T03:24:03.412Z","Included","auto","No","6202","0","281401","601","288204","0.08"
"2025-09-12T03:23:44.688Z","Errored, Not Charged","auto","No","2519","0","556149","525","559193","0.14"
"2025-09-12T03:21:49.882Z","Errored, Not Charged","auto","No","112167","3548","1135153","2957","1253825","0.74"
"2025-09-12T03:20:52.057Z","Included","auto","No","508","0","83180","149","83837","0.02"
"2025-09-12T03:20:30.645Z","Included","auto","No","11486","0","233901","559","245946","0.07"
"2025-09-12T03:18:33.800Z","Included","auto","No","7192","0","520958","1879","530029","0.14"
"2025-09-12T03:14:52.450Z","Included","auto","No","24427","0","701296","18372","744095","0.27"
"2025-09-12T03:13:48.762Z","Included","auto","No","54219","0","7128","218","61565","0.06"
"2025-09-12T03:12:04.451Z","Included","auto","No","17804","0","162862","1043","181709","0.06"
"2025-09-12T03:10:26.166Z","Included","auto","No","4790","0","840634","3161","848585","0.23"
"2025-09-12T03:08:21.787Z","Included","auto","No","1008","0","77271","473","78752","0.02"
"2025-09-12T03:07:33.708Z","Included","auto","No","444","0","38241","205","38890","0.01"
"2025-09-12T03:05:49.609Z","Included","auto","No","31107","0","120416","238","151761","0.06"
"2025-09-12T03:05:49.170Z","Included","auto","No","12709","0","752422","2562","767693","0.21"
"2025-09-12T03:04:19.176Z","Errored, Not Charged","auto","No","796","0","45339","73","46208","0.01"
"2025-09-12T03:04:01.753Z","Errored, Not Charged","auto","No","2367","0","130263","233","132863","0.04"
"2025-09-12T03:03:07.702Z","Errored, Not Charged","auto","No","1184","0","141771","273","143228","0.04"
"2025-09-12T03:02:17.662Z","Included","auto","No","24352","0","46072","762","71186","0.04"
"2025-09-12T03:00:08.292Z","Included","auto","No","13915","0","801142","2930","817987","0.23"
"2025-09-12T02:58:07.624Z","Errored, Not Charged","auto","No","25275","0","479362","2899","507536","0.16"
"2025-09-12T02:57:23.966Z","Errored, Not Charged","auto","No","32743","0","345565","3603","381911","0.13"
"2025-09-12T02:54:48.891Z","Included","auto","No","3111","0","17223","191","20525","0.01"
"2025-09-12T02:53:06.837Z","Errored, Not Charged","auto","No","74373","153807","1391559","12332","1632071","0.73"
"2025-09-12T02:52:44.166Z","Included","auto","No","1144","0","122420","105","123669","0.03"
"2025-09-12T02:52:06.113Z","Errored, Not Charged","auto","No","53538","0","416479","1361","471378","0.16"
"2025-09-12T02:47:36.375Z","Errored, Not Charged","auto","No","87560","0","2669490","10110","2767160","0.80"
"2025-09-12T02:42:49.390Z","Included","auto","No","2079","0","249050","669","251798","0.07"
"2025-09-12T02:38:32.837Z","Included","auto","No","3303","0","393227","825","397355","0.10"
"2025-09-12T02:36:15.820Z","Errored, Not Charged","auto","No","42562","0","2153201","6809","2202572","0.61"
"2025-09-12T02:34:37.052Z","Included","auto","No","51940","0","124847","183","176970","0.08"
"2025-09-12T02:32:45.984Z","Included","auto","No","815","0","57497","212","58524","0.02"
"2025-09-12T02:32:10.140Z","Included","auto","No","1348","0","112521","1365","115234","0.03"
"2025-09-12T02:30:49.199Z","Errored, Not Charged","auto","No","43002","0","82508","724","126234","0.07"
"2025-09-12T02:30:09.778Z","Included","auto","No","1803","0","22368","543","24714","0.01"
"2025-09-12T02:29:38.439Z","Included","auto","No","3878","0","17126","430","21434","0.01"
"2025-09-12T02:27:07.034Z","Included","auto","No","44735","101102","162837","12020","320694","0.14"
"2025-09-12T02:23:50.948Z","Included","auto","No","106460","0","425369","563","532392","0.22"
"2025-09-12T02:22:00.823Z","Included","auto","No","50313","0","1318878","935","1370126","0.38"
"2025-09-12T02:20:04.508Z","Included","auto","No","11945","0","247276","135","259356","0.07"
"2025-09-12T02:18:27.530Z","Errored, Not Charged","auto","No","8398","0","665967","2113","676478","0.18"
"2025-09-12T02:17:34.804Z","Errored, Not Charged","auto","No","1846","0","128300","823","130969","0.04"
"2025-09-12T02:15:48.624Z","Included","auto","No","4355","0","493045","1108","498508","0.13"
"2025-09-12T02:15:08.117Z","Errored, Not Charged","auto","No","24411","0","29950","60","54421","0.03"
"2025-09-12T02:14:12.428Z","Included","auto","No","1713","0","372437","587","374737","0.10"
"2025-09-12T02:11:52.997Z","Included","auto","No","7943","0","482809","805","491557","0.13"
"2025-09-12T02:09:03.580Z","Included","auto","No","4192","0","416195","1339","421726","0.11"
"2025-09-12T02:08:34.301Z","Included","auto","No","236","0","39929","41","40206","0.01"
"2025-09-12T02:08:12.755Z","Included","auto","No","453","0","79206","271","79930","0.02"
"2025-09-12T02:07:28.609Z","Included","auto","No","32351","0","46432","256","79039","0.04"
"2025-09-12T02:06:37.045Z","Included","auto","No","0","0","0","0","0","0.00"
"2025-09-12T02:04:25.414Z","Included","auto","No","5629","0","282371","1830","289830","0.08"
"2025-09-12T02:03:29.674Z","Included","auto","No","2910","0","127330","336","130576","0.04"
"2025-09-12T01:53:12.221Z","Included","auto","No","140165","142687","1358796","27178","1668826","0.60"
"2025-09-12T01:22:52.743Z","Included","auto","No","213658","39584","9864790","17326","10135358","2.75"
"2025-09-12T00:20:27.930Z","Included","auto","No","18068","0","994486","10478","1023032","0.31"
"2025-09-12T00:19:52.120Z","Included","auto","No","36229","0","96516","359","133104","0.06"
"2025-09-12T00:08:50.442Z","Errored, Not Charged","auto","No","52011","733905","313935","14129","1113980","0.29"
"2025-09-12T00:04:19.435Z","Errored, Not Charged","auto","No","18261","0","17065","234","35560","0.02"
"2025-09-12T00:01:05.471Z","Errored, Not Charged","auto","No","23805","75957","1373401","17343","1490506","0.44"
"2025-09-11T23:59:25.725Z","Included","auto","No","10135","155482","957539","27322","1150478","0.37"
"2025-09-11T23:58:17.192Z","Errored, Not Charged","auto","No","2082","0","176132","149","178363","0.05"
"2025-09-11T23:55:48.251Z","Included","auto","No","6387","0","1179252","3075","1188714","0.31"
"2025-09-11T23:52:38.539Z","Included","auto","No","6210","0","1874431","2502","1883143","0.48"
"2025-09-11T23:51:07.179Z","Included","auto","No","6095","0","138622","442","145159","0.04"
"2025-09-11T23:48:43.002Z","Included","auto","No","10411","0","990541","1410","1002362","0.26"
"2025-09-11T23:47:16.690Z","Included","auto","No","3922","0","424914","1897","430733","0.12"
"2025-09-11T23:46:42.093Z","Included","auto","No","368","0","117542","115","118025","0.03"
"2025-09-11T23:44:39.477Z","Errored, Not Charged","auto","No","5664","0","52880","61","58605","0.02"
"2025-09-11T23:42:50.519Z","Included","auto","No","3848","0","501640","1825","507313","0.14"
"2025-09-11T23:42:06.529Z","Included","auto","No","1344","0","321246","490","323080","0.08"
"2025-09-11T23:39:45.328Z","Included","auto","No","9356","0","96244","176","105776","0.03"
"2025-09-11T23:37:07.550Z","Included","auto","No","45132","0","633828","2840","681800","0.21"
"2025-09-11T23:36:03.844Z","Included","auto","No","4365","0","332173","580","337118","0.09"
"2025-09-11T23:20:20.320Z","Included","auto","No","29498","96890","947622","15500","1089510","0.34"
"2025-09-11T23:16:59.835Z","Included","auto","No","23809","0","2347473","3371","2374653","0.62"
"2025-09-11T22:52:20.973Z","Included","auto","No","15646","0","4442257","5172","4463075","1.15"
"2025-09-11T22:51:52.812Z","Errored, Not Charged","auto","No","926","0","259066","339","260331","0.07"
"2025-09-11T22:45:33.386Z","Included","auto","No","6554","0","585755","1186","593495","0.16"
"2025-09-11T22:39:13.961Z","Included","auto","No","3795","0","813895","1462","819152","0.21"
"2025-09-11T22:37:05.116Z","Included","auto","No","72382","0","862986","1259","936627","0.29"
"2025-09-11T21:12:41.015Z","Errored, Not Charged","auto","No","15649","0","1169191","1727","1186567","0.31"
"2025-09-11T21:06:19.806Z","Included","auto","No","64978","0","2222554","4408","2291940","0.64"
"2025-09-11T21:01:04.983Z","Included","auto","No","38789","0","318433","875","358097","0.12"
"2025-09-11T20:54:39.023Z","Included","auto","No","7434","0","1372631","2126","1382191","0.36"
"2025-09-11T20:53:45.144Z","Included","auto","No","44024","0","160125","499","204648","0.09"
"2025-09-11T20:48:11.034Z","Included","auto","No","55379","82192","1699126","13690","1850387","0.54"
"2025-09-11T20:46:45.477Z","Errored, Not Charged","auto","No","10050","0","734823","960","745833","0.20"
"2025-09-11T20:44:21.787Z","Included","auto","No","3604","0","1033855","1156","1038615","0.27"
"2025-09-11T20:43:52.937Z","Included","auto","No","461","0","101053","270","101784","0.03"
"2025-09-11T20:40:54.517Z","Included","auto","No","13068","0","1667060","1435","1681563","0.44"
"2025-09-11T20:36:36.934Z","Included","auto","No","8623","0","2205289","2479","2216391","0.57"
"2025-09-11T20:35:18.306Z","Included","auto","No","81270","0","7129","514","88913","0.09"
"2025-09-11T20:34:11.040Z","Included","auto","No","776","0","175080","319","176175","0.05"
"2025-09-11T20:24:43.314Z","Included","auto","No","64122","0","790586","1630","856338","0.27"
"2025-09-11T20:16:56.635Z","Included","auto","No","18974","0","3017020","8541","3044535","0.81"
"2025-09-11T20:11:04.430Z","Included","auto","No","23673","0","2031681","6672","2062026","0.56"
"2025-09-11T20:09:32.314Z","Included","auto","No","36701","0","345263","579","382543","0.13"
"2025-09-11T20:06:08.501Z","Errored, Not Charged","auto","No","40231","78975","406450","19506","545162","0.23"
"2025-09-11T20:05:17.867Z","Errored, Not Charged","auto","No","28694","5058","277225","1882","312859","0.12"
"2025-09-11T20:02:19.625Z","Included","auto","No","11526","0","1431658","3487","1446671","0.38"
"2025-09-11T20:01:20.213Z","Errored, Not Charged","auto","No","4161","0","345998","2223","352382","0.10"
"2025-09-11T19:49:05.329Z","Errored, Not Charged","auto","No","84648","0","876785","1751","963184","0.31"
"2025-09-11T19:47:43.904Z","Errored, Not Charged","auto","No","983","3552","209830","3663","218028","0.08"
"2025-09-11T19:45:30.454Z","Included","auto","No","8715","0","402453","1563","412731","0.12"
"2025-09-11T19:42:34.271Z","Included","auto","No","5709","0","751478","1974","759161","0.20"
"2025-09-11T19:41:36.372Z","Included","auto","No","40095","0","445071","391","485557","0.15"
"2025-09-11T19:16:41.337Z","Included","auto","No","34068","0","2283792","13170","2331030","0.66"
"2025-09-11T19:15:22.361Z","Errored, Not Charged","auto","No","13080","0","117303","2605","132988","0.05"
"2025-09-11T19:12:57.531Z","Errored, Not Charged","auto","No","28462","0","14410","125","42997","0.03"
"2025-09-11T19:09:32.212Z","Included","auto","No","0","0","0","0","0","0.00"
"2025-09-11T19:08:09.653Z","Errored, Not Charged","auto","No","0","90672","0","8542","99214","0.04"
"2025-09-11T19:04:59.414Z","Errored, Not Charged","auto","No","6425","0","738003","2864","747292","0.20"
"2025-09-11T19:04:40.821Z","Errored, Not Charged","auto","No","11895","0","89400","112","101407","0.03"
"2025-09-11T19:00:36.325Z","Included","auto","No","11761","0","1038247","3080","1053088","0.28"
"2025-09-11T18:51:44.440Z","Errored, Not Charged","auto","No","81885","0","1323016","5185","1410086","0.43"
"2025-09-11T11:01:06.546Z","Included","auto","No","192852","759250","4190376","19712","5162190","1.78"
"2025-09-11T10:48:55.039Z","Included","auto","No","123377","348","2853912","6531","2984168","1.12"
"2025-09-11T10:33:35.320Z","Included","auto","No","149781","87587","3389686","11802","3638856","1.05"
"2025-09-11T10:31:25.787Z","Errored, Not Charged","auto","No","3946","0","779044","1542","784532","0.20"
"2025-09-11T10:26:55.035Z","Errored, Not Charged","auto","No","6874","0","1554119","1293","1562286","0.40"
"2025-09-11T10:26:05.171Z","Errored, Not Charged","auto","No","16036","0","161066","127","177229","0.06"
"2025-09-11T10:18:12.554Z","Included","auto","No","104564","255","3790474","5944","3901237","1.56"
"2025-09-11T10:02:20.888Z","Included","auto","No","109262","347","4235794","9923","4355326","1.43"
"2025-09-11T09:51:36.614Z","Included","auto","No","41593","80279","4619792","7780","4749444","1.24"
"2025-09-11T09:48:25.526Z","Included","auto","No","4916","0","1165384","2139","1172439","0.30"
"2025-09-11T09:45:32.956Z","Included","auto","No","18722","0","797771","3261","819754","0.23"
"2025-09-11T09:44:12.217Z","Included","auto","No","1164","0","226954","456","228574","0.06"
"2025-09-11T09:43:30.400Z","Included","auto","No","7469","0","367367","435","375271","0.10"
"2025-09-11T09:39:14.354Z","Included","auto","No","6428","0","780180","5168","791776","0.22"
"2025-09-11T09:36:52.405Z","Errored, Not Charged","auto","No","66419","0","702854","3718","772991","0.26"
"2025-09-11T09:34:22.347Z","Included","auto","No","339","0","58778","172","59289","0.02"
"2025-09-11T09:28:16.831Z","Errored, Not Charged","auto","No","30237","0","1658430","5685","1694352","0.47"
"2025-09-11T09:14:34.624Z","Included","auto","No","16908","0","1109241","26419","1152568","0.40"
"2025-09-11T09:09:10.890Z","Errored, Not Charged","auto","No","19442","91277","43923","508","155150","0.04"
"2025-09-11T09:02:17.292Z","Included","auto","No","52357","0","2772852","2750","2827959","0.76"
"2025-09-11T08:54:28.432Z","Included","auto","No","87407","0","2632789","3055","2723251","0.76"
"2025-09-11T08:39:29.819Z","Errored, Not Charged","auto","No","5032","0","928202","1301","934535","0.24"
"2025-09-11T08:38:12.314Z","Included","auto","No","48444","0","116629","267","165340","0.08"
"2025-09-11T06:09:53.133Z","Included","auto","No","25298","0","1064279","8084","1097661","0.32"
"2025-09-11T06:08:13.511Z","Included","auto","No","21972","0","36114","146","58232","0.03"
"2025-09-11T04:57:45.389Z","Included","auto","No","6754","0","357075","995","364824","0.10"
"2025-09-11T04:55:32.772Z","Errored, Not Charged","auto","No","12356","0","9670","66","22092","0.02"
"2025-09-11T04:54:09.424Z","Errored, Not Charged","auto","No","0","0","0","0","0","0.00"
"2025-09-11T04:51:56.009Z","Included","auto","No","101227","0","114730","214","216171","0.13"
"2025-09-11T01:39:42.563Z","Included","auto","No","14105","0","2319924","2686","2336715","0.60"
"2025-09-11T01:39:23.797Z","Errored, Not Charged","auto","No","243","0","185636","84","185963","0.05"
"2025-09-11T01:39:07.111Z","Errored, Not Charged","auto","No","100","0","92379","95","92574","0.02"
"2025-09-11T01:38:47.135Z","Errored, Not Charged","auto","No","83546","0","8288","97","91931","0.09"
"2025-09-11T01:36:49.231Z","Errored, Not Charged","auto","No","84291","827848","7128","11593","930860","0.25"
"2025-09-11T01:02:36.163Z","Included","auto","No","231535","99736","7174048","25349","7530668","2.67"
"2025-09-11T01:01:27.349Z","Errored, Not Charged","auto","No","1995","0","741844","388","744227","0.19"
"2025-09-11T00:59:49.906Z","Errored, Not Charged","auto","No","2813","0","1238954","919","1242686","0.32"
"2025-09-11T00:57:55.793Z","Errored, Not Charged","auto","No","10614","0","876712","1762","889088","0.24"
"2025-09-11T00:55:32.365Z","Included","auto","No","3625","0","840971","2192","846788","0.22"
"2025-09-11T00:54:42.023Z","Errored, Not Charged","auto","No","10578","0","354823","415","365816","0.10"
"2025-09-11T00:49:17.502Z","Errored, Not Charged","auto","No","115565","84","3299757","7339","3422745","1.40"
"2025-09-11T00:48:44.909Z","Included","auto","No","1659","0","225650","828","228137","0.06"
"2025-09-11T00:45:38.235Z","Errored, Not Charged","auto","No","8672","0","1114620","3944","1127236","0.30"
"2025-09-11T00:38:07.458Z","Errored, Not Charged","auto","No","44231","0","1377033","3945","1425209","0.40"
"2025-09-11T00:35:16.699Z","Included","auto","No","28248","0","581291","2579","612118","0.18"
"2025-09-11T00:34:59.392Z","Errored, Not Charged","auto","No","1417","0","63373","254","65044","0.02"
"2025-09-11T00:08:09.354Z","Included","auto","No","440106","263481","8408343","75581","9187511","2.86"
"2025-09-10T23:50:58.207Z","Included","auto","No","205379","115267","7084993","49300","7454939","2.17"
"2025-09-10T23:48:58.844Z","Included","auto","No","51633","0","1191429","4995","1248057","0.37"
"2025-09-10T23:44:56.876Z","Included","auto","No","29729","0","2589860","6673","2626262","0.70"
"2025-09-10T23:42:12.733Z","Errored, Not Charged","auto","No","7850","0","1036442","1391","1045683","0.27"
"2025-09-10T23:39:48.256Z","Errored, Not Charged","auto","No","6612","0","1135948","1028","1143588","0.29"
"2025-09-10T23:31:26.927Z","Errored, Not Charged","auto","No","80759","77190","2400457","22295","2580701","0.78"
"2025-09-10T23:27:59.071Z","Included","auto","No","7654","0","1902525","2705","1912884","0.49"
"2025-09-10T23:26:45.591Z","Included","auto","No","3891","0","75023","210","79124","0.02"
"2025-09-10T23:24:23.114Z","Included","auto","No","3667","0","765720","1545","770932","0.20"
"2025-09-10T23:22:40.281Z","Errored, Not Charged","auto","No","12559","0","854814","1379","868752","0.23"
"2025-09-10T23:19:09.518Z","Included","auto","No","7332","0","1520064","2527","1529923","0.40"
"2025-09-10T23:16:33.174Z","Errored, Not Charged","auto","No","57636","0","716936","1257","775829","0.24"
"2025-09-10T23:12:57.518Z","Included","auto","No","28738","0","834533","1332","864603","0.24"
"2025-09-10T23:08:17.899Z","Included","auto","No","62781","864545","1696577","12271","2636174","0.66"
"2025-09-10T23:02:19.123Z","Included","auto","No","58069","116272","879282","10241","1063864","0.33"
"2025-09-10T22:58:26.647Z","Errored, Not Charged","auto","No","7466","0","1108890","1140","1117496","0.29"
"2025-09-10T22:57:58.902Z","Errored, Not Charged","auto","No","10211","0","493221","712","504144","0.14"
"2025-09-10T22:57:05.111Z","Errored, Not Charged","auto","No","4698","0","935558","1964","942220","0.25"
"2025-09-10T22:56:00.878Z","Included","auto","No","11899","0","655922","1742","669563","0.18"
"2025-09-10T22:53:22.653Z","Included","auto","No","46459","0","1861705","4338","1912502","0.53"
"2025-09-10T22:49:25.833Z","Included","auto","No","6624","0","974172","2458","983254","0.26"
"2025-09-10T22:48:35.833Z","Errored, Not Charged","auto","No","1727","0","88589","463","90779","0.03"
"2025-09-10T22:34:39.638Z","Included","auto","No","196128","64636","2475004","32913","2768681","0.94"
"2025-09-10T22:33:18.218Z","Included","auto","No","17753","0","550165","1733","569651","0.16"
"2025-09-10T22:32:03.837Z","Errored, Not Charged","auto","No","18541","99908","10467","13031","141947","0.08"
"2025-09-10T22:30:00.633Z","Included","auto","No","18782","0","1456356","1909","1477047","0.39"
"2025-09-10T22:21:25.938Z","Errored, Not Charged","auto","No","22576","0","3104067","5216","3131859","0.82"
"2025-09-10T22:20:34.888Z","Errored, Not Charged","auto","No","4840","0","950421","1727","956988","0.25"
"2025-09-10T22:18:19.210Z","Errored, Not Charged","auto","No","13317","0","1545719","2204","1561240","0.41"
"2025-09-10T22:17:07.163Z","Errored, Not Charged","auto","No","21934","0","1092307","2770","1117011","0.31"
"2025-09-10T22:16:56.123Z","Errored, Not Charged","auto","No","1923","0","159339","434","161696","0.04"
"2025-09-10T22:14:50.628Z","Errored, Not Charged","auto","No","32025","102868","7128","26329","168350","0.14"
"2025-09-10T22:12:52.944Z","Included","auto","No","4117","0","1074674","2199","1080990","0.28"
"2025-09-10T22:12:11.956Z","Errored, Not Charged","auto","No","5178","0","721559","1811","728548","0.19"
"2025-09-10T22:11:06.400Z","Errored, Not Charged","auto","No","24969","0","851183","2886","879038","0.25"
"2025-09-10T22:08:27.691Z","Included","auto","No","6058","0","2087602","2819","2096479","0.54"
"2025-09-10T22:07:41.236Z","Errored, Not Charged","auto","No","10950","0","741112","1088","753150","0.20"
"2025-09-10T22:07:37.068Z","Errored, Not Charged","auto","No","1643","0","74965","64","76672","0.02"
"2025-09-10T22:06:14.510Z","Errored, Not Charged","auto","No","15424","0","1259651","1446","1276521","0.34"
"2025-09-10T22:04:23.511Z","Included","auto","No","13968","0","621950","1039","636957","0.17"
"2025-09-10T22:00:56.037Z","Errored, Not Charged","auto","No","40076","0","633330","1205","674611","0.20"
"2025-09-10T21:49:24.512Z","Included","auto","No","14119","0","2396376","1727","2412222","0.62"
"2025-09-10T21:48:13.527Z","Included","auto","No","23958","0","888159","1568","913685","0.25"
"2025-09-10T21:46:43.030Z","Included","auto","No","5419","0","374201","992","380612","0.10"
"2025-09-10T21:44:36.383Z","Errored, Not Charged","auto","No","5370","0","1317112","1617","1324099","0.34"
"2025-09-10T21:43:50.569Z","Errored, Not Charged","auto","No","5434","0","731760","2502","739696","0.20"
"2025-09-10T21:38:48.672Z","Errored, Not Charged","auto","No","41322","0","2058988","7404","2107714","0.59"
"2025-09-10T21:34:07.056Z","Included","auto","No","12484","0","637243","2240","651967","0.18"
"2025-09-10T21:33:31.188Z","Errored, Not Charged","auto","No","27684","0","415844","1468","444996","0.14"
"2025-09-10T21:24:24.934Z","Included","auto","No","104131","830333","3761407","15741","4711612","1.23"
"2025-09-10T21:21:04.625Z","Included","auto","No","36412","0","965245","2116","1003773","0.29"
"2025-09-10T21:20:08.505Z","Errored, Not Charged","auto","No","9558","0","637652","361","647571","0.17"
"2025-09-10T21:19:25.530Z","Errored, Not Charged","auto","No","24163","0","281017","269","305449","0.10"
"2025-09-10T21:18:30.630Z","Included","auto","No","12058","0","569337","940","582335","0.16"
"2025-09-10T21:17:23.304Z","Errored, Not Charged","auto","No","1798","0","704279","563","706640","0.18"
"2025-09-10T21:16:38.736Z","Errored, Not Charged","auto","No","2087","0","515070","724","517881","0.13"
"2025-09-10T21:14:56.895Z","Errored, Not Charged","auto","No","7651","0","649925","1891","659467","0.18"
"2025-09-10T21:13:32.858Z","Errored, Not Charged","auto","No","70296","717067","7128","8251","802742","0.21"
"2025-09-10T20:38:09.694Z","Included","auto","No","87582","97468","2290154","11532","2486736","0.72"
"2025-09-10T20:37:37.506Z","Errored, Not Charged","auto","No","1299","0","583425","426","585150","0.15"
"2025-09-10T20:37:09.341Z","Errored, Not Charged","auto","No","8819","0","566458","627","575904","0.15"
"2025-09-10T20:34:25.554Z","Errored, Not Charged","auto","No","14900","0","2215457","2173","2232530","0.58"
"2025-09-10T20:26:12.920Z","Included","auto","No","19976","0","794246","942","815164","0.22"
"2025-09-10T20:22:19.530Z","Errored, Not Charged","auto","No","102957","0","1631530","2850","1737337","0.52"
"2025-09-10T20:16:58.189Z","Included","auto","No","106431","0","3597061","3365","3706857","1.02"
"2025-09-10T20:14:56.304Z","Included","auto","No","5193","0","684318","964","690475","0.18"
"2025-09-10T20:13:17.765Z","Included","auto","No","10080","0","1724355","3068","1737503","0.45"
"2025-09-10T20:12:33.427Z","Included","auto","No","1539","0","363954","627","366120","0.10"
"2025-09-10T20:11:11.204Z","Included","auto","No","96022","0","260724","634","357380","0.16"
"2025-09-10T20:03:01.119Z","Included","auto","No","83599","84720","2146050","8932","2323301","0.67"
"2025-09-10T20:02:32.017Z","Included","auto","No","2894","0","373512","623","377029","0.10"
"2025-09-10T19:59:25.981Z","Included","auto","No","30205","0","2457121","9008","2496334","0.68"
"2025-09-10T19:58:55.825Z","Included","auto","No","11579","0","327728","1051","340358","0.10"
"2025-09-10T19:58:49.706Z","Errored, Not Charged","auto","No","32974","0","29529","49","62552","0.04"
"2025-09-10T19:53:05.019Z","Errored, Not Charged","auto","No","58316","0","2127559","2754","2188629","0.60"
"2025-09-10T19:49:39.361Z","Included","auto","No","3499","0","424617","1111","429227","0.11"
"2025-09-10T19:41:28.698Z","Included","auto","No","95639","295117","220016","3802","614574","0.21"
"2025-09-10T19:35:05.155Z","Included","auto","No","197589","72309","2231481","5579","2506958","0.79"
"2025-09-10T19:33:01.586Z","Errored, Not Charged","auto","No","28126","0","928510","656","957292","0.26"
"2025-09-10T19:32:57.625Z","Errored, Not Charged","auto","No","276","0","81609","41","81926","0.02"
"2025-09-10T19:24:05.801Z","Included","auto","No","321","0","81463","38","81822","0.02"
"2025-09-10T19:13:38.667Z","Errored, Not Charged","auto","No","12882","0","1133143","3757","1149782","0.31"
"2025-09-10T19:11:37.752Z","Included","auto","No","61477","0","342445","650","404572","0.15"
"2025-09-10T18:46:49.491Z","Included","auto","No","56182","207482","2161872","11308","2436844","0.67"
"2025-09-10T18:42:04.851Z","Included","auto","No","19655","0","565882","3903","589440","0.18"
"2025-09-10T18:41:55.273Z","Errored, Not Charged","auto","No","2061","0","219810","104","221975","0.06"
"2025-09-10T18:40:01.733Z","Included","auto","No","36982","0","842036","1459","880477","0.25"
"2025-09-10T18:26:47.869Z","Included","auto","No","7536","0","1048263","1548","1057347","0.28"
"2025-09-10T18:20:41.999Z","Included","auto","No","85258","0","1052086","1555","1138899","0.35"
"2025-09-10T18:11:23.958Z","Included","auto","No","71650","0","2020285","6555","2098490","0.60"
"2025-09-10T16:25:07.579Z","Included","auto","No","50724","6796","406787","2026","466333","0.03"
"2025-09-10T16:22:31.240Z","Included","auto","No","110618","4792","4207967","12392","4335769","0.24"
"2025-09-10T07:54:16.540Z","Errored, Not Charged","claude-4-sonnet-thinking","No","0","561","0","10","571","0.000"
"2025-09-10T07:53:45.110Z","Errored, Not Charged","claude-4-sonnet-thinking","Yes","285","461","408623","424","409793","0.03"
"2025-09-10T07:53:33.556Z","Included","claude-4-sonnet-thinking","Yes","258","424","408365","265","409312","0.03"
"2025-09-10T07:53:23.729Z","Included","claude-4-sonnet-thinking","Yes","230","384","408135","201","408950","0.03"
"2025-09-10T07:53:13.693Z","Included","claude-4-sonnet-thinking","Yes","236","383","407899","153","408671","0.03"
"2025-09-10T07:53:02.666Z","Included","claude-4-sonnet-thinking","Yes","426","408","407473","158","408465","0.03"
"2025-09-10T07:52:45.275Z","Included","claude-4-sonnet-thinking","Yes","688","393","406785","339","408205","0.03"
"2025-09-10T07:52:34.514Z","Included","claude-4-sonnet-thinking","Yes","239","393","406546","177","407355","0.03"
"2025-09-10T07:52:23.646Z","Included","claude-4-sonnet-thinking","Yes","377","410","406169","174","407130","0.03"
"2025-09-10T07:51:59.953Z","Included","claude-4-sonnet-thinking","Yes","4418","391","401751","312","406872","0.03"
"2025-09-10T07:51:47.691Z","Included","claude-4-sonnet-thinking","Yes","589","380","401162","243","402374","0.03"
"2025-09-10T07:51:35.463Z","Included","claude-4-sonnet-thinking","Yes","104","89","401058","394","401645","0.03"
"2025-09-10T07:48:35.527Z","Errored, Not Charged","claude-4-sonnet-thinking","Yes","0","0","0","0","0","0.00"
"2025-09-10T07:48:00.554Z","Errored, Not Charged","claude-4-sonnet-thinking","Yes","401","416","401058","168","402043","0.03"
"2025-09-10T07:47:49.601Z","Included","claude-4-sonnet-thinking","Yes","739","54","400319","327","401439","0.03"
"2025-09-10T07:47:40.186Z","Errored, Not Charged","claude-4-sonnet-thinking","Yes","0","0","0","0","0","0.00"
"2025-09-10T07:47:26.608Z","Included","claude-4-sonnet-thinking","Yes","890","10","400319","176","401395","0.03"
"2025-09-10T07:47:11.679Z","Included","claude-4-sonnet-thinking","Yes","389487","55","10832","351","400725","0.35"
"2025-09-10T07:46:58.005Z","Errored, Not Charged","claude-4-sonnet-thinking","Yes","0","0","0","0","0","0.00"
"2025-09-10T07:46:38.345Z","Included","claude-4-sonnet-thinking","Yes","793","661","400309","143","401906","0.03"
"2025-09-10T07:44:52.401Z","Included","claude-4-sonnet-thinking","Yes","634","618","399675","470","401397","0.03"
"2025-09-10T07:44:08.567Z","Included","claude-4-sonnet-thinking","Yes","374","7724","399301","895","408294","0.04"
"2025-09-10T07:43:58.636Z","Included","claude-4-sonnet-thinking","Yes","333","4","398968","283","399588","0.03"
"2025-09-10T07:43:47.080Z","Included","claude-4-sonnet-thinking","Yes","432","386","398536","226","399580","0.03"
"2025-09-10T07:43:36.827Z","Included","claude-4-sonnet-thinking","Yes","344","393","398192","167","399096","0.03"
"2025-09-10T07:43:26.153Z","Included","claude-4-sonnet-thinking","Yes","317","378","397875","173","398743","0.03"
"2025-09-10T07:43:08.236Z","Included","claude-4-sonnet-thinking","Yes","658","692","397217","183","398750","0.03"
"2025-09-10T07:42:57.365Z","Included","claude-4-sonnet-thinking","Yes","341","8","396876","532","397757","0.03"
"2025-09-10T07:42:41.442Z","Included","claude-4-sonnet-thinking","Yes","262","385","396614","194","397455","0.03"
"2025-09-10T07:42:28.104Z","Included","claude-4-sonnet-thinking","Yes","997","9","395617","181","396804","0.03"
"2025-09-10T07:42:16.784Z","Included","claude-4-sonnet-thinking","Yes","407","9","395210","591","396217","0.03"
"2025-09-10T07:41:55.708Z","Included","claude-4-sonnet-thinking","Yes","1739","46","393471","313","395569","0.03"
"2025-09-10T07:41:47.026Z","Errored, Not Charged","claude-4-sonnet-thinking","Yes","0","0","0","0","0","0.00"
"2025-09-10T07:41:34.147Z","Included","claude-4-sonnet-thinking","Yes","432","9","395087","196","395724","0.03"
"2025-09-10T07:41:24.290Z","Included","claude-4-sonnet-thinking","Yes","661","9","394426","158","395254","0.03"
"2025-09-10T07:41:06.296Z","Included","claude-4-sonnet-thinking","Yes","955","10","393471","419","394855","0.03"
"2025-09-10T07:40:40.042Z","Included","claude-4-sonnet-thinking","Yes","308","189","393163","246","393906","0.03"
"2025-09-10T07:40:29.852Z","Errored, Not Charged","claude-4-sonnet-thinking","No","0","390","0","10","400","0.000"
"2025-09-10T07:40:14.517Z","Included","claude-4-sonnet-thinking","Yes","393","417","393163","179","394152","0.03"
"2025-09-10T07:40:00.228Z","Included","claude-4-sonnet-thinking","Yes","1604","39","391559","258","393460","0.03"
"2025-09-10T07:39:49.254Z","Errored, Not Charged","claude-4-sonnet-thinking","Yes","0","0","0","0","0","0.00"
"2025-09-10T07:39:35.293Z","Included","claude-4-sonnet-thinking","Yes","719","12","393215","274","394220","0.03"
"2025-09-10T07:39:22.188Z","Included","claude-4-sonnet-thinking","Yes","959","12","392256","491","393718","0.03"
"2025-09-10T07:39:09.705Z","Included","claude-4-sonnet-thinking","Yes","697","13","391559","225","392494","0.03"
"2025-09-10T07:38:23.998Z","Included","claude-4-sonnet-thinking","Yes","380727","38","10832","423","392020","0.34"
"2025-09-10T07:38:17.673Z","Errored, Not Charged","claude-4-sonnet-thinking","No","0","385","0","10","395","0.000"
"2025-09-10T07:37:54.989Z","Errored, Not Charged","claude-4-sonnet-thinking","Yes","387","412","392299","176","393274","0.03"
"2025-09-10T07:37:43.033Z","Included","claude-4-sonnet-thinking","Yes","486","8","391813","357","392664","0.03"
"2025-09-10T07:37:35.046Z","Included","claude-4-sonnet-thinking","Yes","514","8","391299","132","391953","0.03"
"2025-09-10T07:37:26.414Z","Included","claude-4-sonnet-thinking","Yes","449","8","390850","149","391456","0.03"
"2025-09-10T07:37:15.609Z","Included","claude-4-sonnet-thinking","Yes","564","8","390286","164","391022","0.03"
"2025-09-10T07:37:01.832Z","Included","claude-4-sonnet-thinking","Yes","1245","8","389041","313","390607","0.03"
"2025-09-10T07:36:51.419Z","Included","claude-4-sonnet-thinking","Yes","736","9","388305","696","389746","0.03"
"2025-09-10T07:36:41.479Z","Included","claude-4-sonnet-thinking","Yes","707","9","387598","396","388710","0.03"
"2025-09-10T07:36:31.249Z","Included","claude-4-sonnet-thinking","Yes","653","9","386945","329","387936","0.03"
"2025-09-10T07:36:18.287Z","Included","claude-4-sonnet-thinking","Yes","1015","9","385930","358","387312","0.03"
"2025-09-10T07:35:59.392Z","Included","claude-4-sonnet-thinking","Yes","2368","9","383562","584","386523","0.03"
"2025-09-10T07:35:47.385Z","Included","claude-4-sonnet-thinking","Yes","685","9","382877","1331","384902","0.03"
"2025-09-10T07:35:22.785Z","Included","claude-4-sonnet-thinking","Yes","8433","424","374444","326","383627","0.04"
"2025-09-10T07:35:12.739Z","Included","claude-4-sonnet-thinking","Yes","359","10","374085","194","374648","0.03"
"2025-09-10T07:35:03.300Z","Included","claude-4-sonnet-thinking","Yes","600","37","373485","256","374378","0.03"
"2025-09-10T07:34:54.858Z","Errored, Not Charged","claude-4-sonnet-thinking","Yes","0","0","0","0","0","0.00"
"2025-09-10T07:34:41.335Z","Included","claude-4-sonnet-thinking","Yes","700","11","373485","223","374419","0.03"
"2025-09-10T07:34:23.369Z","Included","claude-4-sonnet-thinking","Yes","362653","46","10832","222","373753","0.33"
"2025-09-10T07:34:19.536Z","Errored, Not Charged","claude-4-sonnet-thinking","Yes","0","0","0","0","0","0.00"
"2025-09-10T07:33:36.144Z","Errored, Not Charged","claude-4-sonnet-thinking","Yes","179","381","374221","15","374796","0.03"
"2025-09-10T07:33:04.877Z","Included","claude-4-sonnet-thinking","Yes","394","369","373827","159","374749","0.03"
"2025-09-10T07:32:51.406Z","Included","claude-4-sonnet-thinking","Yes","1165","0","372662","142","373969","0.03"
"2025-09-10T07:32:43.518Z","Included","claude-4-sonnet-thinking","Yes","722","0","371940","646","373308","0.03"
"2025-09-10T07:32:28.407Z","Included","claude-4-sonnet-thinking","Yes","986","0","370954","130","372070","0.03"
"2025-09-10T07:32:19.927Z","Included","claude-4-sonnet-thinking","Yes","822","0","370132","925","371879","0.03"
"2025-09-10T07:32:05.002Z","Errored, Not Charged","claude-4-sonnet-thinking","Yes","892","0","369240","123","370255","0.03"
"2025-09-10T07:31:56.545Z","Included","claude-4-sonnet-thinking","Yes","528","0","368712","821","370061","0.03"
"2025-09-10T07:31:37.220Z","Errored, Not Charged","claude-4-sonnet-thinking","Yes","1117","0","367595","131","368843","0.03"
"2025-09-10T07:31:26.598Z","Included","claude-4-sonnet-thinking","Yes","737","0","366858","1046","368641","0.03"
"2025-09-10T07:31:16.529Z","Included","claude-4-sonnet-thinking","Yes","737","0","366121","368","367226","0.03"
"2025-09-10T07:31:06.698Z","Included","claude-4-sonnet-thinking","Yes","673","0","365448","368","366489","0.03"
"2025-09-10T07:30:56.821Z","Included","claude-4-sonnet-thinking","Yes","709","1","364739","349","365798","0.03"
"2025-09-10T07:30:44.442Z","Included","claude-4-sonnet-thinking","Yes","1123","2","363616","378","365119","0.03"
"2025-09-10T07:30:32.160Z","Included","claude-4-sonnet-thinking","Yes","1937","3","361679","682","364301","0.03"
"2025-09-10T07:30:23.659Z","Included","claude-4-sonnet-thinking","Yes","440","4","361239","191","361874","0.03"
"2025-09-10T07:30:13.311Z","Included","claude-4-sonnet-thinking","Yes","5036","29","356203","312","361580","0.03"
"2025-09-10T07:29:41.660Z","Errored, Not Charged","claude-4-sonnet-thinking","Yes","0","0","0","0","0","0.00"
"2025-09-10T07:29:21.125Z","Errored, Not Charged","claude-4-sonnet-thinking","Yes","5239","5","356203","388","361835","0.03"
"2025-09-10T07:29:04.439Z","Included","claude-4-sonnet-thinking","Yes","13185","4717","343018","442","361362","0.04"
"2025-09-10T07:28:53.984Z","Errored, Not Charged","claude-4-sonnet-thinking","Yes","0","0","0","0","0","0.00"
"2025-09-10T07:28:42.080Z","Included","claude-4-sonnet-thinking","Yes","704","4","356367","154","357229","0.03"
"2025-09-10T07:28:30.276Z","Included","claude-4-sonnet-thinking","Yes","868","4","355499","146","356517","0.03"
"2025-09-10T07:28:21.919Z","Included","claude-4-sonnet-thinking","Yes","669","4","354830","614","356117","0.03"
"2025-09-10T07:28:08.584Z","Included","claude-4-sonnet-thinking","Yes","1181","4","353649","158","354992","0.03"
"2025-09-10T07:27:59.033Z","Included","claude-4-sonnet-thinking","Yes","792","4","352857","786","354439","0.03"
"2025-09-10T07:27:50.163Z","Included","claude-4-sonnet-thinking","Yes","555","4","352302","170","353031","0.03"
"2025-09-10T07:27:36.660Z","Included","claude-4-sonnet-thinking","Yes","971","5","351331","192","352499","0.03"
"2025-09-10T07:27:25.111Z","Included","claude-4-sonnet-thinking","Yes","7842","5","343489","698","352034","0.03"
"2025-09-10T07:27:15.219Z","Included","claude-4-sonnet-thinking","Yes","471","5","343018","136","343630","0.03"
"2025-09-10T07:27:02.985Z","Included","claude-4-sonnet-thinking","Yes","6039","45","336979","374","343437","0.03"
"2025-09-10T07:26:55.355Z","Errored, Not Charged","claude-4-sonnet-thinking","Yes","0","0","0","0","0","0.00"
"2025-09-10T07:26:42.172Z","Included","claude-4-sonnet-thinking","Yes","803","4","343401","147","344355","0.03"
"2025-09-10T07:26:31.969Z","Included","claude-4-sonnet-thinking","Yes","638","4","342763","469","343874","0.03"
"2025-09-10T07:26:22.903Z","Included","claude-4-sonnet-thinking","Yes","612","5","342151","242","343010","0.03"
"2025-09-10T07:26:13.996Z","Included","claude-4-sonnet-thinking","Yes","419","5","341732","169","342325","0.03"
"2025-09-10T07:26:06.489Z","Included","claude-4-sonnet-thinking","Yes","714","6","341018","191","341929","0.03"
"2025-09-10T07:25:32.625Z","Included","claude-4-sonnet-thinking","Yes","1183","6","339835","191","341215","0.03"
"2025-09-10T07:24:50.685Z","Included","claude-4-sonnet-thinking","Yes","589","6","339246","755","340596","0.03"
"2025-09-10T07:24:41.265Z","Included","claude-4-sonnet-thinking","Yes","682","7","338564","248","339501","0.03"
"2025-09-10T07:24:33.307Z","Included","claude-4-sonnet-thinking","Yes","821","7","337743","176","338747","0.03"
"2025-09-10T07:24:24.533Z","Included","claude-4-sonnet-thinking","Yes","764","7","336979","182","337932","0.03"
"2025-09-10T07:24:14.038Z","Included","claude-4-sonnet-thinking","Yes","2649","71","334330","323","337373","0.03"
"2025-09-10T07:22:07.217Z","Included","claude-4-sonnet-thinking","Yes","321","389","336681","756","338147","0.03"
"2025-09-10T07:21:57.412Z","Included","claude-4-sonnet-thinking","Yes","334","374","336347","223","337278","0.03"
"2025-09-10T07:21:38.127Z","Included","claude-4-sonnet-thinking","Yes","292","388","336055","161","336896","0.03"
"2025-09-10T07:21:29.533Z","Included","claude-4-sonnet-thinking","Yes","282","417","335773","194","336666","0.03"
"2025-09-10T07:21:18.633Z","Included","claude-4-sonnet-thinking","Yes","747","408","335026","262","336443","0.03"
"2025-09-10T07:21:02.205Z","Included","claude-4-sonnet-thinking","Yes","696","405","334330","497","335928","0.03"
"2025-09-10T07:21:00.376Z","Errored, Not Charged","claude-4-sonnet-thinking","No","0","402","0","10","412","0.000"
"2025-09-10T07:20:49.277Z","Included","claude-4-sonnet-thinking","Yes","1249","35","333081","435","334800","0.03"
"2025-09-10T07:20:41.624Z","Included","claude-4-sonnet-thinking","Yes","372","393","334284","705","335754","0.03"
"2025-09-10T07:20:29.661Z","Included","claude-4-sonnet-thinking","Yes","425","372","333859","298","334954","0.03"
"2025-09-10T07:20:18.664Z","Included","claude-4-sonnet-thinking","Yes","778","388","333081","259","334506","0.03"
"2025-09-10T07:20:16.577Z","Errored, Not Charged","claude-4-sonnet-thinking","No","0","377","0","10","387","0.000"
"2025-09-10T07:20:03.595Z","Included","claude-4-sonnet-thinking","Yes","9417","67","323664","231","333379","0.03"
"2025-09-10T07:20:03.189Z","Included","claude-4-sonnet-thinking","Yes","9417","67","323664","235","333383","0.03"
"2025-09-10T07:19:52.727Z","Errored, Not Charged","claude-4-sonnet-thinking","No","0","404","0","10","414","0.000"
"2025-09-10T07:19:40.510Z","Included","claude-4-sonnet-thinking","Yes","236","383","333533","188","334340","0.02"
"2025-09-10T07:19:30.319Z","Included","claude-4-sonnet-thinking","Yes","302","404","333231","163","334100","0.02"
"2025-09-10T07:18:45.631Z","Included","claude-4-sonnet-thinking","Yes","2007","392","331224","178","333801","0.03"
"2025-09-10T07:18:36.444Z","Included","claude-4-sonnet-thinking","Yes","264","408","330960","165","331797","0.02"
"2025-09-10T07:18:28.358Z","Included","claude-4-sonnet-thinking","Yes","240","383","330720","218","331561","0.02"
"2025-09-10T07:18:09.532Z","Included","claude-4-sonnet-thinking","Yes","3995","391","326725","171","331282","0.03"
"2025-09-10T07:18:00.288Z","Included","claude-4-sonnet-thinking","Yes","315","386","326410","186","327297","0.02"
"2025-09-10T07:17:50.960Z","Included","claude-4-sonnet-thinking","Yes","1444","10","324966","191","326611","0.03"
"2025-09-10T07:17:43.175Z","Included","claude-4-sonnet-thinking","Yes","515","11","324451","167","325144","0.02"
"2025-09-10T07:17:34.102Z","Included","claude-4-sonnet-thinking","Yes","272","381","324179","166","324998","0.02"
"2025-09-10T07:17:24.926Z","Included","claude-4-sonnet-thinking","Yes","515","382","323664","175","324736","0.02"
"2025-09-10T07:17:16.221Z","Included","claude-4-sonnet-thinking","Yes","0","98","323664","308","324070","0.02"
"2025-09-10T07:17:08.944Z","Errored, Not Charged","claude-4-sonnet-thinking","Yes","0","0","0","0","0","0.00"
"2025-09-10T07:16:52.597Z","Included","claude-4-sonnet-thinking","Yes","312832","57","10832","360","324081","0.28"
"2025-09-10T07:15:15.925Z","Included","claude-4-sonnet-thinking","Yes","985","0","323338","899","325222","0.03"
"2025-09-10T07:15:07.971Z","Included","claude-4-sonnet-thinking","Yes","369","0","322969","503","323841","0.03"
"2025-09-10T07:14:58.909Z","Included","claude-4-sonnet-thinking","Yes","418","384","322551","131","323484","0.02"
"2025-09-10T07:14:42.342Z","Included","claude-4-sonnet-thinking","Yes","614","718","321937","153","323422","0.02"
"2025-09-10T07:14:30.817Z","Included","claude-4-sonnet-thinking","Yes","710","0","321227","476","322413","0.03"
"2025-09-10T07:14:21.143Z","Included","claude-4-sonnet-thinking","Yes","746","0","320481","352","321579","0.03"
"2025-09-10T07:14:13.116Z","Included","claude-4-sonnet-thinking","Yes","394","0","320087","415","320896","0.02"
"2025-09-10T07:14:05.802Z","Included","claude-4-sonnet-thinking","Yes","322","0","319765","192","320279","0.02"
"2025-09-10T07:13:56.553Z","Included","claude-4-sonnet-thinking","Yes","418","380","319347","170","320315","0.02"
"2025-09-10T07:13:38.658Z","Included","claude-4-sonnet-thinking","Yes","690","785","318657","180","320312","0.02"
"2025-09-10T07:13:31.243Z","Included","claude-4-sonnet-thinking","Yes","431","0","318226","555","319212","0.03"
"2025-09-10T07:12:49.937Z","Included","claude-4-sonnet-thinking","Yes","1718","385","316508","173","318784","0.02"
"2025-09-10T07:12:20.117Z","Included","claude-4-sonnet-thinking","Yes","401","370","316107","171","317049","0.02"
"2025-09-10T07:12:05.754Z","Included","claude-4-sonnet-thinking","Yes","860","384","315247","158","316649","0.02"
"2025-09-10T07:11:55.619Z","Included","claude-4-sonnet-thinking","Yes","781","3","314466","148","315398","0.02"
"2025-09-10T07:11:40.872Z","Included","claude-4-sonnet-thinking","Yes","1209","388","313257","445","315299","0.03"
"2025-09-10T07:10:54.966Z","Included","claude-4-sonnet-thinking","Yes","1402","4","311855","156","313417","0.02"
"2025-09-10T07:10:38.718Z","Included","claude-4-sonnet-thinking","Yes","1108","4","310747","771","312630","0.03"
"2025-09-10T07:10:29.075Z","Included","claude-4-sonnet-thinking","Yes","806","4","309941","591","311342","0.03"
"2025-09-10T07:10:19.048Z","Included","claude-4-sonnet-thinking","Yes","825","4","309116","440","310385","0.02"
"2025-09-10T07:10:09.270Z","Included","claude-4-sonnet-thinking","Yes","922","4","308194","439","309559","0.02"
"2025-09-10T07:09:58.680Z","Errored, Not Charged","claude-4-sonnet-thinking","Yes","805","4","307389","487","308685","0.02"
"2025-09-10T07:09:49.055Z","Included","claude-4-sonnet-thinking","Yes","771","4","306618","501","307894","0.02"
"2025-09-10T07:09:36.729Z","Included","claude-4-sonnet-thinking","Yes","888","4","305730","450","307072","0.02"
"2025-09-10T07:09:29.404Z","Included","claude-4-sonnet-thinking","Yes","454","5","305276","469","306204","0.02"
"2025-09-10T07:09:21.441Z","Included","claude-4-sonnet-thinking","Yes","365","6","304911","250","305532","0.02"
"2025-09-10T07:09:14.538Z","Included","claude-4-sonnet-thinking","Yes","356","7","304555","117","305035","0.02"
"2025-09-10T07:09:07.244Z","Included","claude-4-sonnet-thinking","Yes","582","7","303973","159","304721","0.02"
"2025-09-10T07:09:00.036Z","Included","claude-4-sonnet-thinking","Yes","368","7","303605","166","304146","0.02"
"2025-09-10T07:08:52.348Z","Included","claude-4-sonnet-thinking","Yes","733","8","302872","160","303773","0.02"
"2025-09-10T07:08:45.526Z","Included","claude-4-sonnet-thinking","Yes","1368","9","301504","163","303044","0.02"
"2025-09-10T07:08:36.322Z","Included","claude-4-sonnet-thinking","Yes","1597","9","299907","207","301720","0.02"
"2025-09-10T07:08:29.053Z","Included","claude-4-sonnet-thinking","Yes","459","10","299448","161","300078","0.02"
"2025-09-10T07:08:17.671Z","Included","claude-4-sonnet-thinking","Yes","288616","49","10832","245","299742","0.26"
"2025-09-10T07:07:52.373Z","Errored, Not Charged","claude-4-sonnet-thinking","Yes","0","0","0","0","0","0.00"
"2025-09-10T07:07:41.592Z","Included","claude-4-sonnet-thinking","Yes","1132","0","299688","608","301428","0.02"
"2025-09-10T07:07:29.422Z","Included","claude-4-sonnet-thinking","Yes","1077","1","298611","614","300303","0.02"
"2025-09-10T07:07:19.710Z","Included","claude-4-sonnet-thinking","Yes","794","2","297817","585","299198","0.02"
"2025-09-10T07:07:13.300Z","Included","claude-4-sonnet-thinking","Yes","438","2","297379","405","298224","0.02"
"2025-09-10T07:07:01.415Z","Included","claude-4-sonnet-thinking","Yes","1305","2","296074","131","297512","0.02"
"2025-09-10T07:06:53.773Z","Included","claude-4-sonnet-thinking","Yes","474","2","295600","700","296776","0.02"
"2025-09-10T07:06:46.258Z","Included","claude-4-sonnet-thinking","Yes","522","2","295078","137","295739","0.02"
"2025-09-10T07:06:38.186Z","Included","claude-4-sonnet-thinking","Yes","612","3","294466","179","295260","0.02"
"2025-09-10T07:06:31.190Z","Included","claude-4-sonnet-thinking","Yes","471","3","293995","342","294811","0.02"
"2025-09-10T07:06:14.481Z","Included","claude-4-sonnet-thinking","Yes","12836","388","281159","321","294704","0.03"
"2025-09-10T07:05:08.477Z","Included","claude-4-sonnet-thinking","Yes","5616","4","275543","162","281325","0.03"
"2025-09-10T07:05:02.089Z","Included","claude-4-sonnet-thinking","Yes","163","5","275380","5571","281119","0.04"
"2025-09-10T07:04:46.660Z","Included","claude-4-sonnet-thinking","Yes","430","5","274950","130","275515","0.02"
"2025-09-10T07:04:28.779Z","Included","claude-4-sonnet-thinking","Yes","1036","5","273914","180","275135","0.02"
"2025-09-10T07:04:20.644Z","Included","claude-4-sonnet-thinking","Yes","416","5","273498","560","274479","0.02"
"2025-09-10T07:04:13.819Z","Included","claude-4-sonnet-thinking","Yes","385","5","273113","168","273671","0.02"
"2025-09-10T07:04:07.013Z","Included","claude-4-sonnet-thinking","Yes","445","5","272668","159","273277","0.02"
"2025-09-10T07:03:57.637Z","Included","claude-4-sonnet-thinking","Yes","840","5","271828","163","272836","0.02"
"2025-09-10T07:03:49.907Z","Included","claude-4-sonnet-thinking","Yes","477","5","271351","473","272306","0.02"
"2025-09-10T07:03:39.049Z","Errored, Not Charged","claude-4-sonnet-thinking","Yes","925","5","270426","166","271522","0.02"
"2025-09-10T07:03:31.944Z","Included","claude-4-sonnet-thinking","Yes","426","5","270000","587","271018","0.02"
"2025-09-10T07:03:24.179Z","Included","claude-4-sonnet-thinking","Yes","746","5","269254","148","270153","0.02"
"2025-09-10T07:03:07.671Z","Included","claude-4-sonnet-thinking","Yes","1730","114","267524","387","269755","0.02"
"2025-09-10T07:03:03.596Z","Errored, Not Charged","claude-4-sonnet-thinking","Yes","0","0","0","0","0","0.00"
"2025-09-10T07:02:53.339Z","Included","claude-4-sonnet-thinking","Yes","357","4","269547","145","270053","0.02"
"2025-09-10T07:02:44.914Z","Included","claude-4-sonnet-thinking","Yes","551","4","268996","139","269690","0.02"
"2025-09-10T07:02:37.279Z","Included","claude-4-sonnet-thinking","Yes","526","4","268470","332","269332","0.02"
"2025-09-10T07:02:29.433Z","Included","claude-4-sonnet-thinking","Yes","494","5","267976","229","268704","0.02"
"2025-09-10T07:02:20.726Z","Included","claude-4-sonnet-thinking","Yes","452","5","267524","213","268194","0.02"
"2025-09-10T07:02:11.490Z","Included","claude-4-sonnet-thinking","Yes","740","29","266784","359","267912","0.02"
"2025-09-10T07:02:06.869Z","Errored, Not Charged","claude-4-sonnet-thinking","Yes","0","0","0","0","0","0.00"
"2025-09-10T07:01:55.782Z","Included","claude-4-sonnet-thinking","Yes","387","6","267457","168","268018","0.02"
"2025-09-10T07:01:46.801Z","Included","claude-4-sonnet-thinking","Yes","673","6","266784","245","267708","0.02"
"2025-09-10T07:01:33.256Z","Included","claude-4-sonnet-thinking","Yes","6114","134","260670","358","267276","0.03"
"2025-09-10T07:01:32.136Z","Errored, Not Charged","claude-4-sonnet-thinking","No","0","395","0","10","405","0.000"
"2025-09-10T07:01:20.116Z","Errored, Not Charged","claude-4-sonnet-thinking","Yes","268","386","267041","210","267905","0.02"
"2025-09-10T07:01:12.371Z","Included","claude-4-sonnet-thinking","Yes","613","6","266428","238","267285","0.02"
"2025-09-10T07:00:55.174Z","Included","claude-4-sonnet-thinking","Yes","5758","393","260670","291","267112","0.02"
"2025-09-10T07:00:45.734Z","Included","claude-4-sonnet-thinking","Yes","10403","36","250267","225","260931","0.03"
"2025-09-10T07:00:44.547Z","Errored, Not Charged","claude-4-sonnet-thinking","No","0","373","0","10","383","0.000"
"2025-09-10T07:00:32.144Z","Errored, Not Charged","claude-4-sonnet-thinking","Yes","262","386","260869","180","261697","0.02"
"2025-09-10T07:00:21.629Z","Included","claude-4-sonnet-thinking","Yes","516","443","260353","242","261554","0.02"
"2025-09-10T07:00:04.251Z","Included","claude-4-sonnet-thinking","Yes","9446","405","250907","208","260966","0.03"
"2025-09-10T06:59:53.464Z","Included","claude-4-sonnet-thinking","Yes","448","8","250459","188","251103","0.02"
"2025-09-10T06:59:46.473Z","Included","claude-4-sonnet-thinking","Yes","192","9","250267","415","250883","0.02"
"2025-09-10T06:59:34.222Z","Included","claude-4-sonnet-thinking","Yes","1960","41","248307","123","250431","0.02"
"2025-09-10T06:59:31.159Z","Errored, Not Charged","claude-4-sonnet-thinking","Yes","0","0","0","0","0","0.00"
"2025-09-10T06:59:20.509Z","Included","claude-4-sonnet-thinking","Yes","292","386","250627","192","251497","0.02"
"2025-09-10T06:59:12.240Z","Included","claude-4-sonnet-thinking","Yes","337","385","250290","225","251237","0.02"
"2025-09-10T06:59:04.353Z","Included","claude-4-sonnet-thinking","Yes","750","10","249540","260","250560","0.02"
"2025-09-10T06:58:56.443Z","Included","claude-4-sonnet-thinking","Yes","361","390","249179","147","250077","0.02"
"2025-09-10T06:58:48.460Z","Included","claude-4-sonnet-thinking","Yes","180","11","248999","278","249468","0.02"
"2025-09-10T06:58:41.920Z","Included","claude-4-sonnet-thinking","Yes","692","11","248307","143","249153","0.02"
"2025-09-10T06:58:29.262Z","Included","claude-4-sonnet-thinking","Yes","237475","39","10832","191","248537","0.22"
"2025-09-10T06:56:08.769Z","Included","claude-4-sonnet-thinking","Yes","420","383","249396","779","250978","0.02"
"2025-09-10T06:55:54.236Z","Included","claude-4-sonnet-thinking","Yes","510","605","248886","156","250157","0.02"
"2025-09-10T06:55:46.357Z","Included","claude-4-sonnet-thinking","Yes","607","0","248279","375","249261","0.02"
"2025-09-10T06:55:40.297Z","Included","claude-4-sonnet-thinking","Yes","382","0","247897","295","248574","0.02"
"2025-09-10T06:55:30.171Z","Included","claude-4-sonnet-thinking","Yes","751","0","247146","160","248057","0.02"
"2025-09-10T06:55:19.404Z","Included","claude-4-sonnet-thinking","Yes","402","0","246744","420","247566","0.02"
"2025-09-10T06:55:12.922Z","Included","claude-4-sonnet-thinking","Yes","324","0","246420","201","246945","0.02"
"2025-09-10T06:55:02.355Z","Included","claude-4-sonnet-thinking","Yes","421","384","245999","172","246976","0.02"
"2025-09-10T06:54:46.819Z","Included","claude-4-sonnet-thinking","Yes","548","629","245451","157","246785","0.02"
"2025-09-10T06:54:39.755Z","Included","claude-4-sonnet-thinking","Yes","335","0","245116","416","245867","0.02"
"2025-09-10T06:54:23.037Z","Included","claude-4-sonnet-thinking","Yes","831","396","244285","175","245687","0.02"
"2025-09-10T06:53:53.180Z","Included","claude-4-sonnet-thinking","Yes","389","369","243896","179","244833","0.02"
"2025-09-10T06:53:45.737Z","Included","claude-4-sonnet-thinking","Yes","502","0","243394","138","244034","0.02"
"2025-09-10T06:53:38.948Z","Included","claude-4-sonnet-thinking","Yes","379","0","243015","225","243619","0.02"
"2025-09-10T06:53:30.573Z","Included","claude-4-sonnet-thinking","Yes","653","0","242362","128","243143","0.02"
"2025-09-10T06:53:23.152Z","Included","claude-4-sonnet-thinking","Yes","570","0","241792","324","242686","0.02"
"2025-09-10T06:53:17.084Z","Included","claude-4-sonnet-thinking","Yes","353","0","241439","268","242060","0.02"
"2025-09-10T06:53:08.455Z","Included","claude-4-sonnet-thinking","Yes","658","0","240781","129","241568","0.02"
"2025-09-10T06:53:01.705Z","Included","claude-4-sonnet-thinking","Yes","475","0","240306","328","241109","0.02"
"2025-09-10T06:52:53.431Z","Included","claude-4-sonnet-thinking","Yes","783","0","239523","254","240560","0.02"
"2025-09-10T06:52:43.527Z","Errored, Not Charged","claude-4-sonnet-thinking","Yes","776","0","238747","398","239921","0.02"
"2025-09-10T06:52:35.174Z","Included","claude-4-sonnet-thinking","Yes","1102","0","237645","508","239255","0.02"
"2025-09-10T06:52:06.475Z","Included","claude-4-sonnet-thinking","Yes","407","374","237238","182","238201","0.02"
"2025-09-10T06:51:59.275Z","Included","claude-4-sonnet-thinking","Yes","443","0","236795","154","237392","0.02"
"2025-09-10T06:51:50.197Z","Included","claude-4-sonnet-thinking","Yes","388","0","236407","195","236990","0.02"
"2025-09-10T06:51:34.935Z","Included","claude-4-sonnet-thinking","Yes","619","0","235788","136","236543","0.02"
"2025-09-10T06:51:27.461Z","Included","claude-4-sonnet-thinking","Yes","580","0","235208","310","236098","0.02"
"2025-09-10T06:51:19.207Z","Included","claude-4-sonnet-thinking","Yes","1096","0","234112","273","235481","0.02"
"2025-09-10T06:51:11.871Z","Included","claude-4-sonnet-thinking","Yes","537","0","233575","149","234261","0.02"
"2025-09-10T06:51:04.153Z","Included","claude-4-sonnet-thinking","Yes","646","0","232929","250","233825","0.02"
"2025-09-10T06:50:57.627Z","Included","claude-4-sonnet-thinking","Yes","442","0","232487","314","233243","0.02"
"2025-09-10T06:50:47.809Z","Included","claude-4-sonnet-thinking","Yes","873","0","231614","146","232633","0.02"
"2025-09-10T06:50:39.711Z","Included","claude-4-sonnet-thinking","Yes","701","0","230913","480","232094","0.02"
"2025-09-10T06:50:31.798Z","Included","claude-4-sonnet-thinking","Yes","565","1","230348","376","231290","0.02"
"2025-09-10T06:50:23.924Z","Included","claude-4-sonnet-thinking","Yes","1986","1","228362","189","230538","0.02"
"2025-09-10T06:50:17.705Z","Included","claude-4-sonnet-thinking","Yes","499","2","227863","173","228537","0.02"
"2025-09-10T06:50:17.478Z","Included","claude-4-sonnet-thinking","Yes","559","0","182605","444","183608","0.02"
"2025-09-10T06:50:11.452Z","Errored, Not Charged","claude-4-sonnet-thinking","Yes","117","0","182488","160","182765","0.01"
"2025-09-10T06:50:09.496Z","Included","claude-4-sonnet-thinking","Yes","706","2","227157","208","228073","0.02"
"2025-09-10T06:50:02.823Z","Included","claude-4-sonnet-thinking","Yes","992","3","226165","167","227327","0.02"
"2025-09-10T06:49:54.257Z","Included","claude-4-sonnet-thinking","Yes","342","4","225823","250","226419","0.02"
"2025-09-10T06:49:47.078Z","Included","claude-4-sonnet-thinking","Yes","280","5","225543","185","226013","0.02"
"2025-09-10T06:49:38.910Z","Included","claude-4-sonnet-thinking","Yes","192","6","225351","243","225792","0.02"
"2025-09-10T06:49:31.673Z","Included","claude-4-sonnet-thinking","Yes","734","7","224617","155","225513","0.02"
"2025-09-10T06:49:20.751Z","Included","claude-4-sonnet-thinking","Yes","2091","266","222526","418","225301","0.02"
"2025-09-10T06:49:19.765Z","Errored, Not Charged","claude-4-sonnet-thinking","No","0","377","0","10","387","0.000"
"2025-09-10T06:49:09.477Z","Errored, Not Charged","claude-4-sonnet-thinking","Yes","180","392","224932","157","225661","0.02"
"2025-09-10T06:49:02.817Z","Included","claude-4-sonnet-thinking","Yes","224","387","224708","160","225479","0.02"
"2025-09-10T06:48:49.133Z","Included","claude-4-sonnet-thinking","Yes","482","521","224226","161","225390","0.02"
"2025-09-10T06:48:20.711Z","Included","claude-4-sonnet-thinking","Yes","406","379","223820","417","225022","0.02"
"2025-09-10T06:48:13.964Z","Included","claude-4-sonnet-thinking","Yes","403","9","223417","155","223984","0.02"
"2025-09-10T06:48:00.939Z","Included","claude-4-sonnet-thinking","Yes","338","9","223079","218","223644","0.02"
"2025-09-10T06:46:56.268Z","Included","claude-4-sonnet-thinking","Yes","553","377","222526","190","223646","0.02"
"2025-09-10T06:46:36.390Z","Included","claude-4-sonnet-thinking","Yes","43","34","222483","186","222746","0.02"
"2025-09-10T06:46:36.032Z","Errored, Not Charged","claude-4-sonnet-thinking","No","0","371","0","10","381","0.000"
"2025-09-10T06:46:04.545Z","Errored, Not Charged","claude-4-sonnet-thinking","Yes","229","385","222483","155","223252","0.02"
"2025-09-10T06:45:53.963Z","Included","claude-4-sonnet-thinking","Yes","3532","30","218951","179","222692","0.02"
"2025-09-10T06:44:24.547Z","Included","claude-4-sonnet-thinking","Yes","313","384","221875","697","223269","0.02"
"2025-09-10T06:44:14.092Z","Included","claude-4-sonnet-thinking","Yes","610","414","221265","237","222526","0.02"
"2025-09-10T06:44:06.349Z","Included","claude-4-sonnet-thinking","Yes","269","380","220996","223","221868","0.02"
"2025-09-10T06:43:58.112Z","Included","claude-4-sonnet-thinking","Yes","317","380","220679","157","221533","0.02"
"2025-09-10T06:43:50.219Z","Included","claude-4-sonnet-thinking","Yes","1218","10","219461","191","220880","0.02"
"2025-09-10T06:43:42.760Z","Included","claude-4-sonnet-thinking","Yes","278","393","219183","137","219991","0.02"
"2025-09-10T06:43:37.686Z","Included","claude-4-sonnet-thinking","Yes","232","11","218951","157","219351","0.02"
"2025-09-10T06:43:29.793Z","Included","claude-4-sonnet-thinking","Yes","208119","37","10832","127","219115","0.19"
"2025-09-10T06:43:14.475Z","Included","claude-4-sonnet-thinking","Yes","422","379","219288","770","220859","0.02"
"2025-09-10T06:43:00.553Z","Included","claude-4-sonnet-thinking","Yes","570","568","218718","156","220012","0.02"
"2025-09-10T06:42:51.898Z","Included","claude-4-sonnet-thinking","Yes","208","376","218510","431","219525","0.02"
"2025-09-10T06:42:45.940Z","Included","claude-4-sonnet-thinking","Yes","227","370","218283","145","219025","0.02"
"2025-09-10T06:42:37.530Z","Included","claude-4-sonnet-thinking","Yes","291","395","217992","164","218842","0.02"
"2025-09-10T06:42:26.158Z","Included","claude-4-sonnet-thinking","Yes","272","380","217720","179","218551","0.02"
"2025-09-10T06:42:18.368Z","Included","claude-4-sonnet-thinking","Yes","261","372","217459","156","218248","0.02"
"2025-09-10T06:41:41.645Z","Included","claude-4-sonnet-thinking","Yes","2037","8","215422","168","217635","0.02"
"2025-09-10T06:41:26.190Z","Included","claude-4-sonnet-thinking","Yes","291","391","215131","2012","217825","0.02"
"2025-09-10T06:41:14.652Z","Included","claude-4-sonnet-thinking","Yes","253","389","214878","169","215689","0.02"
"2025-09-10T06:41:11.868Z","Errored, Not Charged","claude-4-sonnet-thinking","No","0","364","0","10","374","0.000"
"2025-09-10T06:41:06.744Z","Included","claude-4-sonnet-thinking","Yes","278","0","182069","119","182466","0.01"
"2025-09-10T06:41:02.232Z","Included","claude-4-sonnet-thinking","Yes","190","0","181879","119","182188","0.01"
"2025-09-10T06:40:57.904Z","Included","claude-4-sonnet-thinking","Yes","398","384","214480","196","215458","0.02"
"2025-09-10T06:40:48.004Z","Included","claude-4-sonnet-thinking","Yes","203648","43","10832","244","214767","0.18"
"2025-09-10T06:40:37.978Z","Errored, Not Charged","claude-4-sonnet-thinking","Yes","181","383","215146","795","216505","0.02"
"2025-09-10T06:40:30.554Z","Included","claude-4-sonnet-thinking","Yes","310","405","214836","161","215712","0.02"
"2025-09-10T06:40:24.332Z","Included","claude-4-sonnet-thinking","Yes","268","425","214568","194","215455","0.02"
"2025-09-10T06:40:18.134Z","Included","claude-4-sonnet-thinking","Yes","258","369","214310","211","215148","0.02"
"2025-09-10T06:40:12.249Z","Included","claude-4-sonnet-thinking","Yes","256","415","214054","151","214876","0.02"
"2025-09-10T06:40:04.796Z","Included","claude-4-sonnet-thinking","Yes","328","440","213726","193","214687","0.02"
"2025-09-10T06:39:57.245Z","Included","claude-4-sonnet-thinking","Yes","480","388","213246","241","214355","0.02"
"2025-09-10T06:39:47.457Z","Included","claude-4-sonnet-thinking","Yes","810","402","212436","201","213849","0.02"
"2025-09-10T06:39:40.809Z","Included","claude-4-sonnet-thinking","Yes","348","387","212088","175","212998","0.02"
"2025-09-10T06:39:34.103Z","Included","claude-4-sonnet-thinking","Yes","272","376","211816","171","212635","0.02"
"2025-09-10T06:39:27.835Z","Included","claude-4-sonnet-thinking","Yes","223","387","211593","166","212369","0.02"
"2025-09-10T06:39:22.300Z","Included","claude-4-sonnet-thinking","Yes","222","379","211371","160","212132","0.02"
"2025-09-10T06:39:09.922Z","Included","claude-4-sonnet-thinking","Yes","295","399","211076","159","211929","0.02"
"2025-09-10T06:38:42.917Z","Included","claude-4-sonnet-thinking","Yes","822","399","210254","188","211663","0.02"
"2025-09-10T06:38:34.095Z","Included","claude-4-sonnet-thinking","Yes","199422","33","10832","235","210522","0.18"
"2025-09-10T06:38:05.142Z","Included","claude-4-sonnet-thinking","Yes","517","0","210164","739","211420","0.02"
"2025-09-10T06:37:56.611Z","Included","claude-4-sonnet-thinking","Yes","504","389","209660","149","210702","0.02"
"2025-09-10T06:37:45.852Z","Included","claude-4-sonnet-thinking","Yes","458","615","209202","161","210436","0.02"
"2025-09-10T06:37:12.056Z","Included","claude-4-sonnet-thinking","Yes","1590","1","207612","385","209588","0.02"
"2025-09-10T06:37:06.494Z","Included","claude-4-sonnet-thinking","Yes","702","2","206910","1559","209173","0.02"
"2025-09-10T06:37:00.541Z","Included","claude-4-sonnet-thinking","Yes","223","379","206687","108","207397","0.02"
"2025-09-10T06:36:42.449Z","Included","claude-4-sonnet-thinking","Yes","981","3","205706","144","206834","0.02"
"2025-09-10T06:36:37.238Z","Included","claude-4-sonnet-thinking","Yes","339","4","205367","942","206652","0.02"
"2025-09-10T06:36:31.453Z","Included","claude-4-sonnet-thinking","Yes","458","5","204909","176","205548","0.02"
"2025-09-10T06:36:21.894Z","Included","claude-4-sonnet-thinking","Yes","292","374","204617","305","205588","0.02"
"2025-09-10T06:36:12.487Z","Included","claude-4-sonnet-thinking","Yes","298","374","204319","215","205206","0.02"
"2025-09-10T06:36:05.218Z","Included","claude-4-sonnet-thinking","Yes","430","425","203889","186","204930","0.02"
"2025-09-10T06:35:57.493Z","Included","claude-4-sonnet-thinking","Yes","400","436","203489","204","204529","0.02"
"2025-09-10T06:35:51.541Z","Included","claude-4-sonnet-thinking","Yes","244","383","203245","211","204083","0.02"
"2025-09-10T06:35:45.832Z","Included","claude-4-sonnet-thinking","Yes","3144","12","200101","164","203421","0.02"
"2025-09-10T06:35:45.079Z","Included","claude-4-sonnet-thinking","Yes","0","0","0","0","0","0.00"
"2025-09-10T06:35:40.281Z","Included","claude-4-sonnet-thinking","Yes","1950","12","198151","153","200266","0.02"
"2025-09-10T06:35:39.541Z","Included","claude-4-sonnet-thinking","Yes","0","0","0","0","0","0.00"
"2025-09-10T06:35:38.776Z","Included","claude-4-sonnet-thinking","Yes","0","0","0","0","0","0.00"
"2025-09-10T06:35:30.748Z","Included","claude-4-sonnet-thinking","Yes","718","11","197433","213","198375","0.02"
"2025-09-10T06:35:20.550Z","Included","claude-4-sonnet-thinking","Yes","186601","38","10832","311","197782","0.17"
"2025-09-10T06:33:57.363Z","Included","claude-4-sonnet-thinking","Yes","595","421","197235","736","198987","0.02"
"2025-09-10T06:33:47.537Z","Included","claude-4-sonnet-thinking","Yes","423","522","196812","197","197954","0.02"
"2025-09-10T06:33:34.754Z","Included","claude-4-sonnet-thinking","Yes","944","3","195868","284","197099","0.02"
"2025-09-10T06:33:23.241Z","Included","claude-4-sonnet-thinking","Yes","902","3","194966","482","196353","0.02"
"2025-09-10T06:33:11.803Z","Included","claude-4-sonnet-thinking","Yes","867","3","194099","467","195436","0.02"
"2025-09-10T06:32:58.670Z","Included","claude-4-sonnet-thinking","Yes","608","3","193491","459","194561","0.02"
"2025-09-10T06:32:51.385Z","Included","claude-4-sonnet-thinking","Yes","520","3","192971","311","193805","0.02"
"2025-09-10T06:32:43.637Z","Included","claude-4-sonnet-thinking","Yes","428","386","192543","186","193543","0.01"
"2025-09-10T06:32:35.343Z","Included","claude-4-sonnet-thinking","Yes","239","369","192304","162","193074","0.01"
"2025-09-10T06:32:28.603Z","Included","claude-4-sonnet-thinking","Yes","314","376","191990","149","192829","0.01"
"2025-09-10T06:32:15.012Z","Included","claude-4-sonnet-thinking","Yes","511","643","191479","155","192788","0.01"
"2025-09-10T06:32:09.887Z","Included","claude-4-sonnet-thinking","Yes","292","373","191187","421","192273","0.02"
"2025-09-10T06:31:58.980Z","Included","claude-4-sonnet-thinking","Yes","502","410","190685","267","191864","0.02"
"2025-09-10T06:31:51.195Z","Included","claude-4-sonnet-thinking","Yes","563","9","190122","204","190898","0.01"
"2025-09-10T06:31:12.013Z","Included","claude-4-sonnet-thinking","Yes","2420","390","187702","225","190737","0.02"
"2025-09-10T06:31:05.425Z","Included","claude-4-sonnet-thinking","Yes","219","380","187483","167","188249","0.01"
"2025-09-10T06:30:59.484Z","Included","claude-4-sonnet-thinking","Yes","448","10","187035","152","187645","0.01"
"2025-09-10T06:30:47.554Z","Included","claude-4-sonnet-thinking","Yes","316","387","186719","172","187594","0.01"
"2025-09-10T06:30:39.033Z","Included","claude-4-sonnet-thinking","Yes","7978","11","178741","235","186965","0.02"
"2025-09-10T06:30:32.518Z","Included","claude-4-sonnet-thinking","Yes","3828","37","174913","230","179008","0.02"
"2025-09-10T06:30:31.807Z","Errored, Not Charged","claude-4-sonnet-thinking","Yes","0","0","0","0","0","0.00"
"2025-09-10T06:30:08.442Z","Included","claude-4-sonnet-thinking","Yes","3968","11","174913","277","179169","0.02"
"2025-09-10T06:29:56.337Z","Included","claude-4-sonnet-thinking","Yes","164081","48","10832","295","175256","0.15"
"2025-09-10T06:29:48.988Z","Errored, Not Charged","claude-4-sonnet-thinking","Yes","0","0","0","0","0","0.00"
"2025-09-10T06:29:32.870Z","Included","claude-4-sonnet-thinking","Yes","1063","393","177101","235","178792","0.01"
"2025-09-10T06:29:26.368Z","Included","claude-4-sonnet-thinking","Yes","394","0","176707","162","177263","0.01"
"2025-09-10T06:29:19.185Z","Included","claude-4-sonnet-thinking","Yes","509","0","176198","211","176918","0.01"
"2025-09-10T06:29:08.968Z","Included","claude-4-sonnet-thinking","Yes","397","0","175801","296","176494","0.01"
"2025-09-10T06:29:00.596Z","Included","claude-4-sonnet-thinking","Yes","620","0","175181","199","176000","0.01"
"2025-09-10T06:28:51.645Z","Included","claude-4-sonnet-thinking","Yes","700","0","174481","336","175517","0.01"
"2025-09-10T06:28:45.276Z","Included","claude-4-sonnet-thinking","Yes","310","1","174171","178","174660","0.01"
"2025-09-10T06:28:27.652Z","Included","claude-4-sonnet-thinking","Yes","387","2","173784","134","174307","0.01"
"2025-09-10T06:28:18.059Z","Included","claude-4-sonnet-thinking","Yes","286","2","173498","167","173953","0.01"
"2025-09-10T06:28:08.615Z","Included","claude-4-sonnet-thinking","Yes","467","2","173031","146","173646","0.01"
"2025-09-10T06:26:48.087Z","Included","claude-4-sonnet-thinking","Yes","14161","395","158870","378","173804","0.03"
"2025-09-10T06:26:36.928Z","Included","claude-4-sonnet-thinking","Yes","1226","3","157644","155","159028","0.01"
"2025-09-10T06:26:30.939Z","Included","claude-4-sonnet-thinking","Yes","570","3","157074","703","158350","0.01"
"2025-09-10T06:26:22.122Z","Included","claude-4-sonnet-thinking","Yes","595","3","156479","130","157207","0.01"
"2025-09-10T06:26:13.928Z","Included","claude-4-sonnet-thinking","Yes","532","3","155947","311","156793","0.01"
"2025-09-10T06:26:06.115Z","Included","claude-4-sonnet-thinking","Yes","389","3","155558","129","156079","0.01"
"2025-09-10T06:25:59.391Z","Included","claude-4-sonnet-thinking","Yes","414","3","155144","181","155742","0.01"
"2025-09-10T06:25:53.196Z","Errored, Not Charged","claude-4-sonnet-thinking","No","0","368","0","10","378","0.000"
"2025-09-10T06:25:52.563Z","Included","claude-4-sonnet-thinking","Yes","467","3","154677","242","155389","0.01"
"2025-09-10T06:25:36.292Z","Included","claude-4-sonnet-thinking","Yes","1070","3","153607","142","154822","0.01"
"2025-09-10T06:25:30.234Z","Included","claude-4-sonnet-thinking","Yes","531","3","153076","610","154220","0.01"
"2025-09-10T06:25:19.170Z","Included","claude-4-sonnet-thinking","Yes","637","3","152439","129","153208","0.01"
"2025-09-10T06:25:12.365Z","Included","claude-4-sonnet-thinking","Yes","561","3","151878","423","152865","0.01"
"2025-09-10T06:25:00.153Z","Included","claude-4-sonnet-thinking","Yes","1162","3","150716","144","152025","0.01"
"2025-09-10T06:24:55.308Z","Included","claude-4-sonnet-thinking","Yes","581","3","150135","677","151396","0.01"
"2025-09-10T06:24:39.993Z","Included","claude-4-sonnet-thinking","Yes","670","3","149465","147","150285","0.01"
"2025-09-10T06:24:29.882Z","Included","claude-4-sonnet-thinking","Yes","669","4","148796","360","149829","0.01"
"2025-09-10T06:24:21.430Z","Included","claude-4-sonnet-thinking","Yes","401","4","148395","374","149174","0.01"
"2025-09-10T06:24:09.847Z","Included","claude-4-sonnet-thinking","Yes","591","4","147804","136","148535","0.01"
"2025-09-10T06:24:03.265Z","Included","claude-4-sonnet-thinking","Yes","342","4","147462","345","148153","0.01"
"2025-09-10T06:23:55.263Z","Errored, Not Charged","claude-4-sonnet-thinking","Yes","353","4","147109","133","147599","0.01"
"2025-09-10T06:23:43.359Z","Included","claude-4-sonnet-thinking","Yes","595","4","146514","282","147395","0.01"
"2025-09-10T06:23:36.030Z","Included","claude-4-sonnet-thinking","Yes","327","4","146187","325","146843","0.01"
"2025-09-10T06:23:27.837Z","Errored, Not Charged","claude-4-sonnet-thinking","Yes","309","4","145878","135","146326","0.01"
"2025-09-10T06:23:21.469Z","Included","claude-4-sonnet-thinking","Yes","647","4","145231","238","146120","0.01"
"2025-09-10T06:22:07.005Z","Included","claude-4-sonnet-thinking","Yes","13629","397","131602","455","146083","0.02"
"2025-09-10T06:22:00.725Z","Included","claude-4-sonnet-thinking","Yes","417","5","131185","156","131763","0.01"
"2025-09-10T06:21:52.036Z","Included","claude-4-sonnet-thinking","Yes","498","5","130687","227","131417","0.01"
"2025-09-10T06:21:43.852Z","Included","claude-4-sonnet-thinking","Yes","476","5","130211","250","130942","0.01"
"2025-09-10T06:21:32.227Z","Included","claude-4-sonnet-thinking","Yes","436","5","129775","267","130483","0.01"
"2025-09-10T06:21:26.277Z","Included","claude-4-sonnet-thinking","Yes","376","5","129399","231","130011","0.01"
"2025-09-10T06:21:21.271Z","Included","claude-4-sonnet-thinking","Yes","448","5","128951","197","129601","0.01"
"2025-09-10T06:21:12.310Z","Included","claude-4-sonnet-thinking","Yes","366","5","128585","146","129102","0.01"
"2025-09-10T06:21:02.696Z","Included","claude-4-sonnet-thinking","Yes","174","5","128411","256","128846","0.01"
"2025-09-10T06:20:57.323Z","Included","claude-4-sonnet-thinking","Yes","1014","6","127397","116","128533","0.01"
"2025-09-10T06:19:49.208Z","Included","claude-4-sonnet-thinking","Yes","9364","397","118033","370","128164","0.02"
"2025-09-10T06:19:41.061Z","Included","claude-4-sonnet-thinking","Yes","609","7","117424","157","118197","0.01"
"2025-09-10T06:19:34.677Z","Included","claude-4-sonnet-thinking","Yes","1059","7","116365","321","117752","0.01"
"2025-09-10T06:19:26.700Z","Included","claude-4-sonnet-thinking","Yes","466","7","115899","129","116501","0.01"
"2025-09-10T06:19:20.571Z","Included","claude-4-sonnet-thinking","Yes","581","7","115318","137","116043","0.01"
"2025-09-10T06:19:11.863Z","Included","claude-4-sonnet-thinking","Yes","642","7","114676","336","115661","0.01"
"2025-09-10T06:19:02.907Z","Included","claude-4-sonnet-thinking","Yes","722","7","113954","177","114860","0.01"
"2025-09-10T06:17:19.939Z","Included","claude-4-sonnet-thinking","Yes","12841","397","101113","384","114735","0.02"
"2025-09-10T06:17:09.634Z","Included","claude-4-sonnet-thinking","Yes","1280","385","99833","163","101661","0.01"
"2025-09-10T06:15:26.245Z","Included","claude-4-sonnet-thinking","Yes","19807","397","80026","188","100418","0.02"
"2025-09-10T06:15:15.501Z","Included","claude-4-sonnet-thinking","Yes","876","390","79150","172","80588","0.01"
"2025-09-10T06:14:55.191Z","Included","claude-4-sonnet-thinking","Yes","9645","397","69505","197","79744","0.01"
"2025-09-10T06:14:36.920Z","Included","claude-4-sonnet-thinking","Yes","718","403","68787","185","70093","0.01"
"2025-09-10T06:14:28.751Z","Included","claude-4-sonnet-thinking","Yes","742","13","68045","211","69011","0.01"
"2025-09-10T06:14:25.535Z","Errored, Not Charged","claude-4-sonnet-thinking","Yes","0","0","0","0","0","0.00"
"2025-09-10T06:14:22.251Z","Included","claude-4-sonnet-thinking","Yes","390","47","67655","360","68452","0.01"
"2025-09-10T06:14:09.867Z","Errored, Not Charged","claude-4-sonnet-thinking","Yes","225","395","68141","123","68884","0.01"
"2025-09-10T06:13:54.577Z","Included","claude-4-sonnet-thinking","Yes","486","13","67655","195","68349","0.01"
"2025-09-10T06:13:46.843Z","Included","claude-4-sonnet-thinking","Yes","56823","41","10832","220","67916","0.05"
"2025-09-10T06:12:46.658Z","Included","claude-4-sonnet-thinking","Yes","945","1","67604","223","68773","0.01"
"2025-09-10T06:12:15.966Z","Included","claude-4-sonnet-thinking","Yes","460","1","67144","709","68314","0.01"
"2025-09-10T06:12:02.869Z","Included","claude-4-sonnet-thinking","Yes","518","402","66626","232","67778","0.01"
"2025-09-10T06:11:53.056Z","Included","claude-4-sonnet-thinking","Yes","250","407","66376","191","67224","0.01"
"2025-09-10T06:11:47.516Z","Included","claude-4-sonnet-thinking","Yes","643","2","65733","183","66561","0.01"
"2025-09-10T06:10:45.020Z","Errored, Not Charged","claude-4-sonnet-thinking","No","0","367","0","10","377","0.000"
"2025-09-10T06:10:44.817Z","Included","claude-4-sonnet-thinking","Yes","14793","382","50940","417","66532","0.02"
"2025-09-10T06:10:39.121Z","Included","claude-4-sonnet-thinking","Yes","468","3","50472","148","51091","0.005"
"2025-09-10T06:10:27.908Z","Included","claude-4-sonnet-thinking","Yes","408","405","50064","240","51117","0.005"
"2025-09-10T06:10:19.505Z","Included","claude-4-sonnet-thinking","Yes","457","4","49607","202","50270","0.005"
"2025-09-10T06:10:06.347Z","Included","claude-4-sonnet-thinking","Yes","431","510","49176","231","50348","0.005"
"2025-09-10T06:09:56.775Z","Included","claude-4-sonnet-thinking","Yes","535","478","48641","316","49970","0.01"
"2025-09-10T06:09:55.979Z","Errored, Not Charged","claude-4-sonnet-thinking","No","0","429","0","10","439","0.000"
"2025-09-10T06:09:51.551Z","Included","claude-4-sonnet-thinking","Yes","883","32","47758","273","48946","0.01"
"2025-09-10T06:08:45.093Z","Errored, Not Charged","claude-4-sonnet-thinking","Yes","462","623","48825","249","50159","0.005"
"2025-09-10T06:08:24.821Z","Included","claude-4-sonnet-thinking","Yes","542","396","48283","442","49663","0.01"
"2025-09-10T06:08:08.356Z","Included","claude-4-sonnet-thinking","Yes","525","452","47758","230","48965","0.005"
"2025-09-10T06:08:01.690Z","Included","claude-4-sonnet-thinking","Yes","3488","31","44270","314","48103","0.01"
"2025-09-10T06:08:01.337Z","Errored, Not Charged","claude-4-sonnet-thinking","Yes","0","0","0","0","0","0.00"
"2025-09-10T06:07:50.063Z","Included","claude-4-sonnet-thinking","Yes","500","4","47842","2","48348","0.004"
"2025-09-10T06:07:41.790Z","Included","claude-4-sonnet-thinking","Yes","356","4","47486","256","48102","0.005"
"2025-09-10T06:07:25.167Z","Included","claude-4-sonnet-thinking","Yes","795","844","46691","660","48990","0.01"
"2025-09-10T06:07:14.249Z","Included","claude-4-sonnet-thinking","Yes","304","394","46387","234","47319","0.004"
"2025-09-10T06:07:04.411Z","Included","claude-4-sonnet-thinking","Yes","386","391","46001","205","46983","0.004"
"2025-09-10T06:06:52.621Z","Included","claude-4-sonnet-thinking","Yes","921","518","45080","258","46777","0.005"
"2025-09-10T06:06:44.622Z","Included","claude-4-sonnet-thinking","Yes","291","373","44789","305","45758","0.005"
"2025-09-10T06:06:33.187Z","Included","claude-4-sonnet-thinking","Yes","519","8","44270","196","44993","0.004"
"2025-09-10T06:06:28.417Z","Included","claude-4-sonnet-thinking","Yes","10567","63","33703","228","44561","0.01"
"2025-09-10T06:06:27.994Z","Errored, Not Charged","claude-4-sonnet-thinking","Yes","0","0","0","0","0","0.00"
"2025-09-10T06:05:58.077Z","Errored, Not Charged","claude-4-sonnet-thinking","No","0","381","0","10","391","0.000"
"2025-09-10T06:05:50.373Z","Included","claude-4-sonnet-thinking","No","0","382","0","10","392","0.000"
"2025-09-10T06:05:28.183Z","Included","claude-4-sonnet-thinking","Yes","1481","370","36377","361","38589","0.01"
"2025-09-10T06:05:20.777Z","Included","claude-4-sonnet-thinking","Yes","388","5","35989","132","36514","0.003"
"2025-09-10T06:05:11.605Z","Included","claude-4-sonnet-thinking","Yes","320","406","35669","184","36579","0.004"
"2025-09-10T06:05:04.510Z","Included","claude-4-sonnet-thinking","Yes","370","6","35299","169","35844","0.003"
"2025-09-10T06:04:56.060Z","Included","claude-4-sonnet-thinking","Yes","362","388","34937","148","35835","0.003"
"2025-09-10T06:04:41.934Z","Included","claude-4-sonnet-thinking","Yes","384","396","34553","230","35563","0.004"
"2025-09-10T06:04:32.009Z","Included","claude-4-sonnet-thinking","Yes","467","406","34086","219","35178","0.004"
"2025-09-10T06:04:22.572Z","Included","claude-4-sonnet-thinking","Yes","383","382","33703","294","34762","0.004"
"2025-09-10T06:04:20.995Z","Errored, Not Charged","claude-4-sonnet-thinking","No","0","394","0","10","404","0.000"
"2025-09-10T06:04:14.417Z","Included","claude-4-sonnet-thinking","Yes","22871","43","10832","203","33949","0.02"
"2025-09-10T06:04:09.098Z","Included","claude-4-sonnet-thinking","Yes","325","386","34230","260","35201","0.004"
"2025-09-10T06:04:01.469Z","Included","claude-4-sonnet-thinking","Yes","341","374","33889","199","34803","0.003"
"2025-09-10T06:03:49.760Z","Included","claude-4-sonnet-thinking","Yes","626","397","33263","231","34517","0.004"
"2025-09-10T06:03:33.905Z","Included","claude-4-sonnet-thinking","Yes","897","451","32366","811","34525","0.01"
"2025-09-10T06:03:26.870Z","Included","claude-4-sonnet-thinking","Yes","309","388","32057","182","32936","0.003"
"2025-09-10T06:03:22.091Z","Included","claude-4-sonnet-thinking","Yes","348","377","31709","173","32607","0.003"
"2025-09-10T06:03:07.040Z","Included","claude-4-sonnet-thinking","Yes","729","453","30980","687","32849","0.005"
"2025-09-10T06:02:58.155Z","Included","claude-4-sonnet-thinking","Yes","336","390","30644","150","31520","0.003"
"2025-09-10T06:02:50.902Z","Included","claude-4-sonnet-thinking","Yes","264","375","30380","233","31252","0.003"
"2025-09-10T06:02:40.784Z","Included","claude-4-sonnet-thinking","Yes","257","384","30123","170","30934","0.003"
"2025-09-10T06:02:32.982Z","Included","claude-4-sonnet-thinking","Yes","304","372","29819","158","30653","0.003"
"2025-09-10T06:02:22.857Z","Included","claude-4-sonnet-thinking","Yes","563","6","29256","208","30033","0.003"
"2025-09-10T06:02:16.927Z","Included","claude-4-sonnet-thinking","Yes","584","38","28672","317","29611","0.004"
"2025-09-10T06:02:16.778Z","Errored, Not Charged","claude-4-sonnet-thinking","Yes","0","0","0","0","0","0.00"
"2025-09-10T06:02:03.696Z","Errored, Not Charged","claude-4-sonnet-thinking","No","0","365","0","10","375","0.000"
"2025-09-10T06:01:59.401Z","Included","claude-4-sonnet-thinking","No","0","379","0","10","389","0.000"
"2025-09-10T06:01:46.690Z","Included","claude-4-sonnet-thinking","Yes","423","7","28672","352","29454","0.004"
"2025-09-10T06:01:44.501Z","Errored, Not Charged","claude-4-sonnet-thinking","No","0","377","0","40","417","0.000"
"2025-09-10T06:01:35.898Z","Included","claude-4-sonnet-thinking","Yes","2264","33","26408","397","29102","0.01"
"2025-09-10T06:01:33.568Z","Errored, Not Charged","claude-4-sonnet-thinking","Yes","917","411","28463","19","29810","0.003"
"2025-09-10T06:01:29.265Z","Included","claude-4-sonnet-thinking","No","0","393","0","10","403","0.000"
"2025-09-10T06:01:19.888Z","Included","claude-4-sonnet-thinking","Yes","603","393","27860","415","29271","0.004"
"2025-09-10T06:01:17.033Z","Included","claude-4-sonnet-thinking","No","0","374","0","10","384","0.000"
"2025-09-10T06:01:05.564Z","Included","claude-4-sonnet-thinking","Yes","715","398","27145","373","28631","0.004"
"2025-09-10T06:01:02.095Z","Included","claude-4-sonnet-thinking","No","0","372","0","10","382","0.000"
"2025-09-10T06:00:54.526Z","Included","claude-4-sonnet-thinking","Yes","737","381","26408","325","27851","0.004"
"2025-09-10T06:00:51.541Z","Included","claude-4-sonnet-thinking","No","0","369","0","10","379","0.000"
"2025-09-10T06:00:40.116Z","Included","claude-4-sonnet-thinking","Yes","11922","47","14486","367","26822","0.01"
"2025-09-10T06:00:39.822Z","Errored, Not Charged","claude-4-sonnet-thinking","No","0","371","0","10","381","0.000"
"2025-09-10T06:00:36.401Z","Errored, Not Charged","claude-4-sonnet-thinking","No","0","373","0","10","383","0.000"
"2025-09-10T06:00:32.202Z","Included","claude-4-sonnet-thinking","Yes","1295","13","25580","14","26902","0.003"
"2025-09-10T06:00:24.964Z","Included","claude-4-sonnet-thinking","No","0","370","0","10","380","0.000"
"2025-09-10T06:00:13.494Z","Included","claude-4-sonnet-thinking","Yes","1208","12","24372","309","25901","0.004"
"2025-09-10T06:00:08.681Z","Included","claude-4-sonnet-thinking","Yes","9886","13","14486","138","24523","0.01"
"2025-09-10T06:00:08.479Z","Included","claude-4-sonnet-thinking","Yes","0","0","0","0","0","0.00"
"2025-09-10T06:00:07.426Z","Included","claude-4-sonnet-thinking","Yes","0","0","0","0","0","0.00"
"2025-09-10T05:59:56.927Z","Included","claude-4-sonnet-thinking","Yes","3654","9","10832","409","14904","0.01"
"2025-09-10T05:55:39.724Z","Errored, Not Charged","claude-4-sonnet-thinking","No","0","363","0","10","373","0.000"
"2025-09-10T05:55:36.312Z","Included","claude-4-sonnet-thinking","Yes","0","21","181406","125","181552","0.01"
"2025-09-10T05:55:31.017Z","Errored, Not Charged","claude-4-sonnet-thinking","No","0","371","0","10","381","0.000"
"2025-09-10T05:53:10.913Z","Errored, Not Charged","claude-4-sonnet-thinking","Yes","172","367","181359","119","182017","0.01"
"2025-09-10T05:53:03.704Z","Errored, Not Charged","claude-4-sonnet-thinking","No","0","367","0","10","377","0.000"
"2025-09-10T05:53:01.811Z","Included","claude-4-sonnet-thinking","Yes","0","22","181359","126","181507","0.01"
"2025-09-10T05:51:13.419Z","Errored, Not Charged","claude-4-sonnet-thinking","Yes","130","367","181359","115","181971","0.01"
"2025-09-10T05:51:08.843Z","Included","claude-4-sonnet-thinking","Yes","239","403","181120","116","181878","0.01"
"2025-09-10T05:51:04.565Z","Included","claude-4-sonnet-thinking","Yes","134","0","180986","167","181287","0.01"
"2025-09-10T05:50:58.890Z","Included","claude-4-sonnet-thinking","Yes","151","0","180835","102","181088","0.01"
"2025-09-10T05:50:51.097Z","Included","claude-4-sonnet-thinking","Yes","215","380","180620","129","181344","0.01"
"2025-09-10T05:50:44.697Z","Included","claude-4-sonnet-thinking","Yes","211","387","180409","130","181137","0.01"
"2025-09-10T05:50:37.637Z","Included","claude-4-sonnet-thinking","Yes","246","387","180163","140","180936","0.01"
"2025-09-10T05:50:11.732Z","Errored, Not Charged","claude-4-sonnet-thinking","Yes","5640","0","174523","165","180328","0.02"
"2025-09-10T05:50:05.948Z","Included","claude-4-sonnet-thinking","Yes","1537","0","172986","2503","177026","0.02"
"2025-09-10T05:49:59.329Z","Included","claude-4-sonnet-thinking","Yes","387","0","172599","129","173115","0.01"
"2025-09-10T05:49:54.592Z","Included","claude-4-sonnet-thinking","Yes","778","0","171821","198","172797","0.01"
"2025-09-10T05:49:47.320Z","Included","claude-4-sonnet-thinking","Yes","508","378","171313","132","172331","0.01"
"2025-09-10T05:49:40.583Z","Included","claude-4-sonnet-thinking","Yes","214","382","171099","175","171870","0.01"
"2025-09-10T05:49:34.023Z","Included","claude-4-sonnet-thinking","Yes","260","380","170839","129","171608","0.01"
"2025-09-10T05:49:27.311Z","Included","claude-4-sonnet-thinking","Yes","761","377","170078","146","171362","0.01"
"2025-09-10T05:49:22.055Z","Included","claude-4-sonnet-thinking","Yes","134","0","169944","115","170193","0.01"
"2025-09-10T05:49:17.306Z","Included","claude-4-sonnet-thinking","Yes","164","0","169780","102","170046","0.01"
"2025-09-10T05:49:11.512Z","Included","claude-4-sonnet-thinking","Yes","160","0","169620","132","169912","0.01"
"2025-09-10T05:49:04.487Z","Included","claude-4-sonnet-thinking","Yes","296","372","169324","123","170115","0.01"
"2025-09-10T05:48:58.648Z","Included","claude-4-sonnet-thinking","Yes","286","367","169038","120","169811","0.01"
"2025-09-10T05:48:49.019Z","Included","claude-4-sonnet-thinking","Yes","31","25","169007","143","169206","0.01"
"2025-09-10T05:48:33.900Z","Errored, Not Charged","claude-4-sonnet-thinking","No","0","367","0","10","377","0.000"
"2025-09-10T05:48:01.999Z","Included","claude-4-sonnet-thinking","Yes","524","479","168483","201","169687","0.01"
"2025-09-10T05:47:54.004Z","Included","claude-4-sonnet-thinking","Yes","376","371","168107","256","169110","0.01"
"2025-09-10T05:47:42.523Z","Included","claude-4-sonnet-thinking","Yes","334","456","167773","119","168682","0.01"
"2025-09-10T05:47:18.963Z","Included","claude-4-sonnet-thinking","Yes","1301","0","166472","212","167985","0.01"
"2025-09-10T05:47:11.556Z","Included","claude-4-sonnet-thinking","Yes","411","0","166061","765","167237","0.02"
"2025-09-10T05:47:02.806Z","Included","claude-4-sonnet-thinking","No","665","1689","165396","755","168505","0.02"
"2025-09-10T05:46:50.592Z","Included","claude-4-sonnet-thinking","No","426","455","164970","234","166085","0.01"
"2025-09-10T05:46:41.410Z","Included","claude-4-sonnet-thinking","Yes","5078","0","159892","327","165297","0.02"
"2025-09-10T05:46:38.763Z","Errored, Not Charged","claude-4-sonnet-thinking","No","0","451","0","10","461","0.000"
"2025-09-10T05:46:36.434Z","Included","claude-4-sonnet-thinking","Yes","0","42","159892","104","160038","0.01"
"2025-09-10T05:45:35.793Z","Errored, Not Charged","claude-4-sonnet-thinking","Yes","232","462","159892","217","160803","0.01"
"2025-09-10T05:45:29.475Z","Included","claude-4-sonnet-thinking","Yes","304","371","159588","218","160481","0.01"
"2025-09-10T05:45:09.325Z","Included","claude-4-sonnet-thinking","Yes","523","465","159065","163","160216","0.01"
"2025-09-10T05:44:28.162Z","Included","claude-4-sonnet-thinking","Yes","931","462","158134","255","159782","0.01"
"2025-09-10T05:44:20.943Z","Included","claude-4-sonnet-thinking","Yes","401","376","157733","236","158746","0.01"
"2025-09-10T05:44:12.632Z","Included","claude-4-sonnet-thinking","Yes","315","450","157418","133","158316","0.01"
"2025-09-10T05:44:06.841Z","Included","claude-4-sonnet-thinking","Yes","320","364","157098","194","157976","0.01"
"2025-09-10T05:44:01.048Z","Included","claude-4-sonnet-thinking","Yes","205","368","156893","111","157577","0.01"
"2025-09-10T05:43:53.547Z","Included","claude-4-sonnet-thinking","Yes","361","363","156532","118","157374","0.01"
"2025-09-10T05:43:45.053Z","Included","claude-4-sonnet-thinking","Yes","367","370","156165","126","157028","0.01"
"2025-09-10T05:43:33.920Z","Included","claude-4-sonnet-thinking","Yes","701","0","155464","146","156311","0.01"
"2025-09-10T05:43:29.999Z","Included","claude-4-sonnet-thinking","Yes","145","0","155319","100","155564","0.01"
"2025-09-10T05:43:26.032Z","Included","claude-4-sonnet-thinking","Yes","405","0","154914","64","155383","0.01"
"2025-09-10T05:43:22.002Z","Included","claude-4-sonnet-thinking","Yes","206","0","154708","63","154977","0.01"
"2025-09-10T05:43:09.437Z","Included","claude-4-sonnet-thinking","Yes","1047","0","153661","125","154833","0.01"
"2025-09-10T05:43:01.579Z","Included","claude-4-sonnet-thinking","Yes","246","1599","153415","1027","156287","0.02"
"2025-09-10T05:42:53.495Z","Included","claude-4-sonnet-thinking","Yes","1513","451","151902","223","154089","0.01"
"2025-09-10T05:42:45.781Z","Included","claude-4-sonnet-thinking","No","949","437","150953","244","152583","0.01"
"2025-09-10T05:42:39.659Z","Included","claude-4-sonnet-thinking","Yes","308","370","150645","217","151540","0.01"
"2025-09-10T05:42:34.284Z","Included","claude-4-sonnet-thinking","Yes","343","372","150302","118","151135","0.01"
"2025-09-10T05:42:29.911Z","Included","claude-4-sonnet-thinking","Yes","635","35","149667","150","150487","0.01"
"2025-09-10T05:41:36.929Z","Included","claude-4-sonnet-thinking","Yes","501","0","149166","632","150299","0.01"
"2025-09-10T05:41:27.165Z","Included","claude-4-sonnet-thinking","Yes","358","467","148808","144","149777","0.01"
"2025-09-10T05:41:22.384Z","Included","claude-4-sonnet-thinking","Yes","310","0","148498","235","149043","0.01"
"2025-09-10T05:41:17.756Z","Included","claude-4-sonnet-thinking","Yes","330","0","148168","159","148657","0.01"
"2025-09-10T05:41:05.173Z","Included","claude-4-sonnet-thinking","Yes","9379","383","138789","252","148803","0.02"
"2025-09-10T05:40:59.629Z","Included","claude-4-sonnet-thinking","Yes","311","0","138478","136","138925","0.01"
"2025-09-10T05:40:55.972Z","Included","claude-4-sonnet-thinking","Yes","254","0","138224","159","138637","0.01"
"2025-09-10T05:40:51.149Z","Included","claude-4-sonnet-thinking","Yes","433","0","137791","166","138390","0.01"
"2025-09-10T05:40:39.540Z","Included","claude-4-sonnet-thinking","Yes","3614","383","134177","240","138414","0.01"
"2025-09-10T05:40:34.996Z","Included","claude-4-sonnet-thinking","Yes","310","0","133867","131","134308","0.01"
"2025-09-10T05:40:29.931Z","Included","claude-4-sonnet-thinking","Yes","254","0","133613","159","134026","0.01"
"2025-09-10T05:40:23.278Z","Errored, Not Charged","claude-4-sonnet-thinking","Yes","665","0","132948","166","133779","0.01"
"2025-09-10T05:40:12.102Z","Included","claude-4-sonnet-thinking","Yes","9390","385","123558","358","133691","0.02"
"2025-09-10T05:39:59.014Z","Included","claude-4-sonnet-thinking","Yes","2090","0","121468","140","123698","0.01"
"2025-09-10T05:39:51.374Z","Included","claude-4-sonnet-thinking","Yes","768","0","120700","1238","122706","0.01"
"2025-09-10T05:39:45.230Z","Included","claude-4-sonnet-thinking","Yes","704","0","119996","371","121071","0.01"
"2025-09-10T05:39:39.967Z","Included","claude-4-sonnet-thinking","Yes","1799","0","118197","182","120178","0.01"
"2025-09-10T05:39:35.381Z","Included","claude-4-sonnet-thinking","Yes","408","0","117789","101","118298","0.01"
"2025-09-10T05:39:28.266Z","Included","claude-4-sonnet-thinking","Yes","233","370","117556","143","118302","0.01"
"2025-09-10T05:39:16.228Z","Errored, Not Charged","claude-4-sonnet-thinking","No","0","394","0","10","404","0.000"
"2025-09-10T05:39:16.155Z","Included","claude-4-sonnet-thinking","Yes","937","0","116619","154","117710","0.01"
"2025-09-10T05:39:12.720Z","Included","claude-4-sonnet-thinking","Yes","44","63","116575","403","117085","0.01"
"2025-09-10T05:39:09.153Z","Errored, Not Charged","claude-4-sonnet-thinking","Yes","152","0","116575","188","116915","0.01"
"2025-09-10T05:39:02.133Z","Included","claude-4-sonnet-thinking","Yes","406","0","116169","128","116703","0.01"
"2025-09-10T05:38:24.692Z","Included","claude-4-sonnet-thinking","Yes","15363","380","100806","306","116855","0.02"
"2025-09-10T05:38:18.279Z","Included","claude-4-sonnet-thinking","Yes","511","0","100295","131","100937","0.01"
"2025-09-10T05:38:08.916Z","Included","claude-4-sonnet-thinking","Yes","360","479","99935","154","100928","0.01"
"2025-09-10T05:38:04.876Z","Included","claude-4-sonnet-thinking","Yes","412","0","99523","232","100167","0.01"
"2025-09-10T05:37:58.565Z","Included","claude-4-sonnet-thinking","Yes","505","0","99018","184","99707","0.01"
"2025-09-10T05:37:55.226Z","Included","claude-4-sonnet-thinking","Yes","326","0","98692","252","99270","0.01"
"2025-09-10T05:37:49.573Z","Included","claude-4-sonnet-thinking","Yes","456","0","98236","127","98819","0.01"
"2025-09-10T05:37:45.711Z","Included","claude-4-sonnet-thinking","Yes","277","0","97959","211","98447","0.01"
"2025-09-10T05:37:41.281Z","Included","claude-4-sonnet-thinking","Yes","216","0","97743","119","98078","0.01"
"2025-09-10T05:37:36.912Z","Included","claude-4-sonnet-thinking","Yes","341","0","97402","139","97882","0.01"
"2025-09-10T05:37:28.444Z","Included","claude-4-sonnet-thinking","Yes","1393","379","96009","237","98018","0.01"
"2025-09-10T05:37:23.683Z","Included","claude-4-sonnet-thinking","Yes","484","0","95525","133","96142","0.01"
"2025-09-10T05:37:13.262Z","Included","claude-4-sonnet-thinking","Yes","694","384","94831","152","96061","0.01"
"2025-09-10T05:37:06.172Z","Included","claude-4-sonnet-thinking","Yes","502","0","94329","135","94966","0.01"
"2025-09-10T05:36:55.025Z","Included","claude-4-sonnet-thinking","Yes","5695","383","88634","392","95104","0.01"
"2025-09-10T05:36:46.498Z","Included","claude-4-sonnet-thinking","Yes","629","0","88005","139","88773","0.01"
"2025-09-10T05:36:35.605Z","Included","claude-4-sonnet-thinking","Yes","6891","383","81114","482","88870","0.01"
"2025-09-10T05:36:27.537Z","Included","claude-4-sonnet-thinking","Yes","541","0","80573","145","81259","0.01"
"2025-09-10T05:36:23.905Z","Included","claude-4-sonnet-thinking","Yes","210","0","80363","399","80972","0.01"
"2025-09-10T05:36:19.689Z","Included","claude-4-sonnet-thinking","Yes","219","0","80144","139","80502","0.01"
"2025-09-10T05:36:13.670Z","Included","claude-4-sonnet-thinking","Yes","334","0","79810","154","80298","0.01"
"2025-09-10T05:36:08.996Z","Included","claude-4-sonnet-thinking","Yes","231","0","79579","242","80052","0.01"
"2025-09-10T05:36:02.551Z","Included","claude-4-sonnet-thinking","Yes","563","0","79016","166","79745","0.01"
"2025-09-10T05:35:53.537Z","Included","claude-4-sonnet-thinking","Yes","1590","369","77426","231","79616","0.01"
"2025-09-10T05:35:48.635Z","Included","claude-4-sonnet-thinking","Yes","360","0","77066","121","77547","0.01"
"2025-09-10T05:35:43.030Z","Included","claude-4-sonnet-thinking","Yes","265","0","76801","154","77220","0.01"
"2025-09-10T05:35:37.399Z","Included","claude-4-sonnet-thinking","Yes","192","0","76609","105","76906","0.01"
"2025-09-10T05:35:33.089Z","Included","claude-4-sonnet-thinking","Yes","477","0","76132","128","76737","0.01"
"2025-09-10T05:35:24.801Z","Errored, Not Charged","claude-4-sonnet-thinking","Yes","456","0","75676","88","76220","0.01"
"2025-09-10T05:35:20.121Z","Included","claude-4-sonnet-thinking","Yes","253","0","75423","195","75871","0.01"
"2025-09-10T05:35:13.397Z","Included","claude-4-sonnet-thinking","Yes","228","0","75195","166","75589","0.01"
"2025-09-10T05:35:07.998Z","Included","claude-4-sonnet-thinking","Yes","254","0","74941","129","75324","0.01"
"2025-09-10T05:35:00.480Z","Included","claude-4-sonnet-thinking","Yes","403","0","74538","104","75045","0.01"
"2025-09-10T05:34:56.225Z","Included","claude-4-sonnet-thinking","Yes","424","0","74114","259","74797","0.01"
"2025-09-10T05:34:50.492Z","Included","claude-4-sonnet-thinking","Yes","403","0","73711","148","74262","0.01"
"2025-09-10T05:34:45.721Z","Included","claude-4-sonnet-thinking","Yes","252","0","73459","105","73816","0.01"
"2025-09-10T05:34:41.424Z","Included","claude-4-sonnet-thinking","Yes","684","0","72775","164","73623","0.01"
"2025-09-10T05:34:35.260Z","Errored, Not Charged","claude-4-sonnet-thinking","Yes","364","0","72411","88","72863","0.01"
"2025-09-10T05:34:30.680Z","Included","claude-4-sonnet-thinking","Yes","425","0","71986","228","72639","0.01"
"2025-09-10T05:34:27.492Z","Included","claude-4-sonnet-thinking","Yes","503","0","71483","283","72269","0.01"
"2025-09-10T05:34:23.979Z","Included","claude-4-sonnet-thinking","Yes","346","0","71137","104","71587","0.01"
"2025-09-10T05:34:18.616Z","Included","claude-4-sonnet-thinking","Yes","298","0","70839","104","71241","0.01"
"2025-09-10T05:34:15.356Z","Included","claude-4-sonnet-thinking","Yes","690","0","70149","190","71029","0.01"
"2025-09-10T05:33:58.220Z","Errored, Not Charged","claude-4-sonnet-thinking","Yes","894","0","69255","100","70249","0.01"
"2025-09-10T05:33:47.870Z","Included","claude-4-sonnet-thinking","Yes","763","0","68492","393","69648","0.01"
"2025-09-10T05:33:43.184Z","Included","claude-4-sonnet-thinking","Yes","18","33","68474","347","68872","0.01"
"2025-09-10T05:33:40.333Z","Errored, Not Charged","claude-4-sonnet-thinking","Yes","0","0","0","0","0","0.00"
"2025-09-10T05:33:21.348Z","Included","claude-4-sonnet-thinking","Yes","1208","0","67266","573","69047","0.01"
"2025-09-10T05:33:16.389Z","Included","claude-4-sonnet-thinking","Yes","0","51","67266","616","67933","0.01"
"2025-09-10T05:32:54.668Z","Errored, Not Charged","claude-4-sonnet-thinking","Yes","0","0","0","0","0","0.00"
"2025-09-10T05:32:51.307Z","Included","claude-4-sonnet-thinking","Yes","0","29","67266","499","67794","0.01"
"2025-09-10T05:32:35.968Z","Errored, Not Charged","claude-4-sonnet-thinking","Yes","0","0","0","0","0","0.00"
"2025-09-10T05:32:30.605Z","Included","claude-4-sonnet-thinking","Yes","370","0","66896","563","67829","0.01"
"2025-09-10T05:32:26.880Z","Included","claude-4-sonnet-thinking","Yes","300","0","66596","262","67158","0.01"
"2025-09-10T05:32:16.905Z","Errored, Not Charged","claude-4-sonnet-thinking","Yes","507","0","66089","104","66700","0.01"
"2025-09-10T05:31:46.602Z","Included","claude-4-sonnet-thinking","Yes","586","0","65503","297","66386","0.01"
"2025-09-10T05:30:49.841Z","Included","claude-4-sonnet-thinking","Yes","3365","1","62138","566","66070","0.01"
"2025-09-10T05:29:57.344Z","Included","claude-4-sonnet-thinking","Yes","3337","2","58801","3336","65476","0.02"
"2025-09-10T05:28:49.586Z","Included","claude-4-sonnet-thinking","Yes","3336","3","55465","3304","62108","0.02"
"2025-09-10T05:28:46.057Z","Included","claude-4-sonnet-thinking","Yes","63","30","55402","3274","58769","0.02"
"2025-09-10T05:27:42.579Z","Errored, Not Charged","claude-4-sonnet-thinking","Yes","0","0","0","0","0","0.00"
"2025-09-10T05:27:13.069Z","Included","claude-4-sonnet-thinking","Yes","1566","384","53836","3502","59288","0.02"
"2025-09-10T05:27:08.495Z","Included","claude-4-sonnet-thinking","Yes","139","5","53697","124","53965","0.004"
"2025-09-10T05:27:03.955Z","Included","claude-4-sonnet-thinking","Yes","530","5","53167","110","53812","0.005"
"2025-09-10T05:27:01.652Z","Errored, Not Charged","claude-4-sonnet-thinking","Yes","0","0","0","0","0","0.00"
"2025-09-10T05:26:57.957Z","Included","claude-4-sonnet-thinking","Yes","0","34","53167","192","53393","0.005"
"2025-09-10T05:26:36.416Z","Errored, Not Charged","claude-4-sonnet-thinking","Yes","136","379","53167","137","53819","0.004"
"2025-09-10T05:26:10.117Z","Included","claude-4-sonnet-thinking","Yes","213","395","52954","122","53684","0.004"
"2025-09-10T05:26:04.975Z","Included","claude-4-sonnet-thinking","Yes","270","388","52684","148","53490","0.005"
"2025-09-10T05:25:57.415Z","Included","claude-4-sonnet-thinking","Yes","524","6","52160","209","52899","0.005"
"2025-09-10T05:25:53.766Z","Included","claude-4-sonnet-thinking","Yes","460","6","51700","99","52265","0.004"
"2025-09-10T05:25:45.732Z","Included","claude-4-sonnet-thinking","Yes","40868","34","10832","155","51889","0.04"
"2025-09-10T05:25:43.244Z","Errored, Not Charged","claude-4-sonnet-thinking","Yes","0","0","0","0","0","0.00"
"2025-09-10T05:25:34.142Z","Included","claude-4-sonnet-thinking","Yes","8014","14","47382","12","55422","0.01"
"2025-09-10T05:25:32.629Z","Included","claude-4-sonnet-thinking","Yes","0","0","0","0","0","0.00"
"2025-09-10T05:25:31.718Z","Included","claude-4-sonnet-thinking","Yes","0","0","0","0","0","0.00"
"2025-09-10T05:25:24.727Z","Included","claude-4-sonnet-thinking","Yes","729","14","46653","417","47813","0.01"
"2025-09-10T05:25:22.867Z","Included","claude-4-sonnet-thinking","Yes","0","0","0","0","0","0.00"
"2025-09-10T05:25:15.282Z","Included","claude-4-sonnet-thinking","Yes","981","14","45672","398","47065","0.01"
"2025-09-10T05:25:14.558Z","Included","claude-4-sonnet-thinking","Yes","0","0","0","0","0","0.00"
"2025-09-10T05:25:12.877Z","Included","claude-4-sonnet-thinking","Yes","0","0","0","0","0","0.00"
"2025-09-10T05:25:02.594Z","Included","claude-4-sonnet-thinking","Yes","3864","399","41808","489","46560","0.01"
"2025-09-10T05:25:00.261Z","Included","claude-4-sonnet-thinking","Yes","0","0","0","0","0","0.00"
"2025-09-10T05:24:54.626Z","Included","claude-4-sonnet-thinking","Yes","867","14","40941","276","42098","0.005"
"2025-09-10T05:24:51.261Z","Included","claude-4-sonnet-thinking","Yes","0","0","0","0","0","0.00"
"2025-09-10T05:24:19.162Z","Included","claude-4-sonnet-thinking","Yes","10204","384","30737","464","41789","0.01"
"2025-09-10T05:24:18.264Z","Included","claude-4-sonnet-thinking","Yes","0","0","0","0","0","0.00"
"2025-09-10T05:24:16.315Z","Included","claude-4-sonnet-thinking","Yes","0","0","0","0","0","0.00"
"2025-09-10T05:24:10.955Z","Included","claude-4-sonnet-thinking","Yes","3890","14","26847","307","31058","0.01"
"2025-09-10T05:24:06.984Z","Included","claude-4-sonnet-thinking","No","0","377","0","10","387","0.000"
"2025-09-10T05:24:00.112Z","Included","claude-4-sonnet-thinking","Yes","3058","384","23789","333","27564","0.01"
"2025-09-10T05:23:56.040Z","Included","claude-4-sonnet-thinking","No","0","370","0","10","380","0.000"
"2025-09-10T05:23:52.891Z","Included","claude-4-sonnet-thinking","No","0","369","0","10","379","0.000"
"2025-09-10T05:23:44.662Z","Included","claude-4-sonnet-thinking","Yes","12957","13","10832","353","24155","0.01"
"2025-09-10T05:23:25.009Z","Errored, Not Charged","claude-4-sonnet-thinking","Yes","0","0","0","0","0","0.00"
"2025-09-10T05:22:50.506Z","Included","claude-4-sonnet-thinking","Yes","10036","328575","10832","7981","357424","0.03"
"2025-09-10T05:22:36.974Z","Included","claude-4-sonnet-thinking","Yes","32858","313986","10832","6590","364266","0.05"
"2025-09-10T05:22:32.269Z","Errored, Not Charged","claude-4-sonnet-thinking","No","0","372","0","10","382","0.000"
"2025-09-10T05:22:03.227Z","Errored, Not Charged","claude-4-sonnet-thinking","Yes","592","746","528435","147","529920","0.04"
"2025-09-10T05:21:51.905Z","Included","claude-4-sonnet-thinking","Yes","283","364","528152","572","529371","0.04"
"2025-09-10T05:21:16.501Z","Included","claude-4-sonnet-thinking","Yes","1908","363","526244","215","528730","0.04"
"2025-09-10T05:21:05.731Z","Included","claude-4-sonnet-thinking","Yes","367","0","525877","119","526363","0.04"
"2025-09-10T05:20:55.726Z","Included","claude-4-sonnet-thinking","Yes","171","0","525706","162","526039","0.04"
"2025-09-10T05:20:45.120Z","Errored, Not Charged","claude-4-sonnet-thinking","Yes","163","0","525543","96","525802","0.04"
"2025-09-10T05:20:34.584Z","Included","claude-4-sonnet-thinking","Yes","243","0","525300","101","525644","0.04"
"2025-09-10T05:20:24.105Z","Included","claude-4-sonnet-thinking","Yes","259","0","525041","167","525467","0.04"
"2025-09-10T05:20:10.708Z","Included","claude-4-sonnet-thinking","Yes","855","0","524186","112","525153","0.04"
"2025-09-10T05:19:39.311Z","Included","claude-4-sonnet-thinking","Yes","482","364","523704","467","525017","0.04"
"2025-09-10T05:19:25.966Z","Included","claude-4-sonnet-thinking","Yes","741","0","522963","128","523832","0.04"
"2025-09-10T05:18:55.771Z","Included","claude-4-sonnet-thinking","Yes","547","363","522416","430","523756","0.04"
"2025-09-10T05:18:44.118Z","Included","claude-4-sonnet-thinking","Yes","573","0","521843","125","522541","0.04"
"2025-09-10T05:17:49.850Z","Included","claude-4-sonnet-thinking","Yes","388","371","521455","359","522573","0.04"
"2025-09-10T05:17:37.748Z","Included","claude-4-sonnet-thinking","Yes","607","0","520848","147","521602","0.04"
"2025-09-10T05:17:27.646Z","Included","claude-4-sonnet-thinking","Yes","528","0","520320","322","521170","0.04"
"2025-09-10T05:17:12.965Z","Included","claude-4-sonnet-thinking","Yes","1432","0","518888","122","520442","0.04"
"2025-09-10T05:17:02.654Z","Included","claude-4-sonnet-thinking","Yes","401","0","518487","620","519508","0.04"
"2025-09-10T05:16:52.278Z","Included","claude-4-sonnet-thinking","Yes","491","0","517996","129","518616","0.04"
"2025-09-10T05:16:41.220Z","Included","claude-4-sonnet-thinking","Yes","359","0","517637","134","518130","0.04"
"2025-09-10T05:16:30.995Z","Included","claude-4-sonnet-thinking","Yes","790","0","516847","158","517795","0.04"
"2025-09-10T05:16:18.366Z","Included","claude-4-sonnet-thinking","Yes","660","0","516187","136","516983","0.04"
"2025-09-10T05:16:06.976Z","Included","claude-4-sonnet-thinking","Yes","745","0","515442","347","516534","0.04"
"2025-09-10T05:15:57.289Z","Included","claude-4-sonnet-thinking","Yes","202","0","515240","130","515572","0.04"
"2025-09-10T05:15:47.544Z","Included","claude-4-sonnet-thinking","Yes","727","1","514513","165","515406","0.04"
"2025-09-10T05:15:37.142Z","Included","claude-4-sonnet-thinking","Yes","179","1","514334","129","514643","0.04"
"2025-09-10T05:15:27.005Z","Included","claude-4-sonnet-thinking","Yes","193","2","514141","142","514478","0.04"
"2025-09-10T05:15:15.057Z","Included","claude-4-sonnet-thinking","Yes","650","3","513491","156","514300","0.04"
"2025-09-10T05:15:04.764Z","Included","claude-4-sonnet-thinking","Yes","457","4","513034","344","513839","0.04"
"2025-09-10T05:14:49.481Z","Included","claude-4-sonnet-thinking","Yes","1232","4","511802","142","513180","0.04"
"2025-09-10T05:14:38.799Z","Included","claude-4-sonnet-thinking","Yes","712","4","511090","578","512384","0.04"
"2025-09-10T05:14:21.385Z","Included","claude-4-sonnet-thinking","Yes","1740","4","509350","138","511232","0.04"
"2025-09-10T05:14:11.023Z","Included","claude-4-sonnet-thinking","Yes","1146","5","508204","833","510188","0.04"
"2025-09-10T05:13:52.205Z","Errored, Not Charged","claude-4-sonnet-thinking","Yes","1142","5","507062","107","508316","0.04"
"2025-09-10T05:13:39.657Z","Included","claude-4-sonnet-thinking","Yes","1005","6","506057","870","507938","0.04"
"2025-09-10T05:13:27.268Z","Included","claude-4-sonnet-thinking","Yes","834","6","505223","553","506616","0.04"
"2025-09-10T05:13:14.868Z","Included","claude-4-sonnet-thinking","Yes","302","386","504921","131","505740","0.04"
"2025-09-10T05:13:02.292Z","Included","claude-4-sonnet-thinking","Yes","485","7","504436","192","505120","0.04"
"2025-09-10T05:12:45.061Z","Included","claude-4-sonnet-thinking","Yes","4153","56","500283","379","504871","0.04"
"2025-09-10T05:12:34.965Z","Errored, Not Charged","claude-4-sonnet-thinking","Yes","0","0","0","0","0","0.00"
"2025-09-10T05:12:20.449Z","Included","claude-4-sonnet-thinking","No","255","397","504761","140","505553","0.04"
"2025-09-10T05:12:09.463Z","Included","claude-4-sonnet-thinking","Yes","322","402","504439","186","505349","0.04"
"2025-09-10T05:11:57.214Z","Included","claude-4-sonnet-thinking","Yes","2357","7","502082","240","504686","0.04"
"2025-09-10T05:11:45.662Z","Included","claude-4-sonnet-thinking","Yes","630","8","501452","173","502263","0.04"
"2025-09-10T05:11:34.080Z","Included","claude-4-sonnet-thinking","Yes","491","8","500961","345","501805","0.04"
"2025-09-10T05:11:21.177Z","Included","claude-4-sonnet-thinking","Yes","251","8","500710","246","501215","0.04"
"2025-09-10T05:11:08.589Z","Included","claude-4-sonnet-thinking","Yes","427","377","500283","223","501310","0.04"
"2025-09-10T05:10:49.787Z","Included","claude-4-sonnet-thinking","Yes","2894","61","497389","289","500633","0.04"
"2025-09-10T05:08:53.210Z","Included","claude-4-sonnet-thinking","Yes","490","386","499609","714","501199","0.04"
"2025-09-10T05:08:41.396Z","Included","claude-4-sonnet-thinking","Yes","354","388","499255","164","500161","0.04"
"2025-09-10T05:08:29.109Z","Included","claude-4-sonnet-thinking","Yes","383","396","498872","160","499811","0.04"
"2025-09-10T05:08:18.476Z","Included","claude-4-sonnet-thinking","Yes","232","380","498640","175","499427","0.04"
"2025-09-10T05:08:07.388Z","Included","claude-4-sonnet-thinking","Yes","287","372","498353","163","499175","0.04"
"2025-09-10T05:07:56.925Z","Included","claude-4-sonnet-thinking","Yes","281","394","498072","172","498919","0.04"
"2025-09-10T05:07:45.065Z","Included","claude-4-sonnet-thinking","Yes","375","375","497697","212","498659","0.04"
"2025-09-10T05:07:32.997Z","Included","claude-4-sonnet-thinking","Yes","308","379","497389","158","498234","0.04"
"2025-09-10T05:07:14.462Z","Included","claude-4-sonnet-thinking","Yes","2952","31","494437","164","497584","0.04"
"2025-09-10T05:05:37.480Z","Included","claude-4-sonnet-thinking","Yes","868","11","495908","1051","497838","0.04"
"2025-09-10T05:05:26.948Z","Included","claude-4-sonnet-thinking","Yes","1015","11","494893","158","496077","0.04"
"2025-09-10T05:05:09.180Z","Included","claude-4-sonnet-thinking","Yes","456","399","494437","120","495412","0.04"
"2025-09-10T05:04:29.873Z","Included","claude-4-sonnet-thinking","Yes","483605","33","10832","300","494770","0.44"
"2025-09-10T05:03:18.692Z","Included","claude-4-sonnet-thinking","Yes","632","633","495348","635","497248","0.04"
"2025-09-10T05:03:03.215Z","Included","claude-4-sonnet-thinking","Yes","2804","370","492544","518","496236","0.04"
"2025-09-10T05:02:50.445Z","Included","claude-4-sonnet-thinking","Yes","2788","369","489756","162","493075","0.04"
"2025-09-10T05:02:40.216Z","Included","claude-4-sonnet-thinking","Yes","277","383","489479","150","490289","0.04"
"2025-09-10T05:02:31.547Z","Included","claude-4-sonnet-thinking","Yes","403","0","489076","164","489643","0.04"
"2025-09-10T05:02:20.268Z","Included","claude-4-sonnet-thinking","Yes","289","369","488787","168","489613","0.04"
"2025-09-10T05:02:07.408Z","Included","claude-4-sonnet-thinking","Yes","2039","368","486748","154","489309","0.04"
"2025-09-10T05:01:57.410Z","Included","claude-4-sonnet-thinking","Yes","227","366","486521","149","487263","0.04"
"2025-09-10T05:01:46.386Z","Included","claude-4-sonnet-thinking","Yes","283","374","486238","143","487038","0.04"
"2025-09-10T05:01:35.173Z","Included","claude-4-sonnet-thinking","Yes","252","370","485986","153","486761","0.04"
"2025-09-10T05:01:25.754Z","Included","claude-4-sonnet-thinking","Yes","698","0","485288","156","486142","0.04"
"2025-09-10T05:01:12.535Z","Included","claude-4-sonnet-thinking","Yes","1211","371","484077","154","485813","0.04"
"2025-09-10T05:01:03.395Z","Included","claude-4-sonnet-thinking","Yes","480","2","483597","147","484226","0.04"
"2025-09-10T05:00:45.618Z","Included","claude-4-sonnet-thinking","Yes","457","2","483140","173","483772","0.04"
"2025-09-10T05:00:33.863Z","Included","claude-4-sonnet-thinking","Yes","511","3","482629","219","483362","0.04"
"2025-09-10T05:00:23.685Z","Included","claude-4-sonnet-thinking","Yes","460","3","482169","260","482892","0.04"
"2025-09-10T05:00:10.455Z","Included","claude-4-sonnet-thinking","Yes","702","3","481467","240","482412","0.04"
"2025-09-10T05:00:01.272Z","Included","claude-4-sonnet-thinking","Yes","398","3","481069","496","481966","0.04"
"2025-09-10T04:59:50.034Z","Included","claude-4-sonnet-thinking","Yes","511","3","480558","173","481245","0.04"
"2025-09-10T04:59:41.025Z","Included","claude-4-sonnet-thinking","Yes","408","3","480150","394","480955","0.04"
"2025-09-10T04:59:28.277Z","Errored, Not Charged","claude-4-sonnet-thinking","Yes","592","3","479558","213","480366","0.04"
"2025-09-10T04:59:15.755Z","Included","claude-4-sonnet-thinking","Yes","799","4","478759","527","480089","0.04"
"2025-09-10T04:59:06.476Z","Included","claude-4-sonnet-thinking","Yes","336","4","478423","477","479240","0.04"
"2025-09-10T04:58:58.148Z","Included","claude-4-sonnet-thinking","Yes","367","4","478056","172","478599","0.04"
"2025-09-10T04:58:49.379Z","Included","claude-4-sonnet-thinking","Yes","372","4","477684","181","478241","0.04"
"2025-09-10T04:58:40.462Z","Included","claude-4-sonnet-thinking","Yes","358","4","477326","167","477855","0.04"
"2025-09-10T04:58:31.887Z","Included","claude-4-sonnet-thinking","Yes","350","4","476976","181","477511","0.04"
"2025-09-10T04:58:22.706Z","Included","claude-4-sonnet-thinking","Yes","346","4","476630","166","477146","0.04"
"2025-09-10T04:58:13.883Z","Errored, Not Charged","claude-4-sonnet-thinking","Yes","287","4","476343","220","476854","0.04"
"2025-09-10T04:58:05.150Z","Included","claude-4-sonnet-thinking","Yes","396","5","475947","201","476549","0.04"
"2025-09-10T04:57:57.027Z","Included","claude-4-sonnet-thinking","Yes","371","5","475576","199","476151","0.04"
"2025-09-10T04:57:48.569Z","Included","claude-4-sonnet-thinking","Yes","439","5","475137","181","475762","0.04"
"2025-09-10T04:57:40.223Z","Included","claude-4-sonnet-thinking","Yes","168","6","474969","143","475286","0.03"
"2025-09-10T04:57:29.473Z","Errored, Not Charged","claude-4-sonnet-thinking","Yes","349","7","474620","131","475107","0.03"
"2025-09-10T04:57:19.903Z","Included","claude-4-sonnet-thinking","Yes","246","7","474374","254","474881","0.04"
"2025-09-10T04:57:11.539Z","Included","claude-4-sonnet-thinking","Yes","158","8","474216","110","474492","0.03"
"2025-09-10T04:57:02.567Z","Included","claude-4-sonnet-thinking","Yes","354","9","473862","121","474346","0.03"
"2025-09-10T04:56:54.814Z","Included","claude-4-sonnet-thinking","Yes","743","9","473119","173","474044","0.04"
"2025-09-10T04:56:46.869Z","Included","claude-4-sonnet-thinking","Yes","175","9","472944","130","473258","0.03"
"2025-09-10T04:56:37.828Z","Included","claude-4-sonnet-thinking","Yes","347","10","472597","138","473092","0.03"
"2025-09-10T04:56:29.042Z","Included","claude-4-sonnet-thinking","Yes","382","10","472215","141","472748","0.03"
"2025-09-10T04:56:19.762Z","Included","claude-4-sonnet-thinking","Yes","168","10","472047","188","472413","0.03"
"2025-09-10T04:56:11.023Z","Included","claude-4-sonnet-thinking","Yes","384","11","471663","131","472189","0.03"
"2025-09-10T04:56:00.595Z","Included","claude-4-sonnet-thinking","Yes","495","11","471168","144","471818","0.03"
"2025-09-10T04:55:51.801Z","Included","claude-4-sonnet-thinking","Yes","209","11","470959","286","471465","0.04"
"2025-09-10T04:55:42.770Z","Included","claude-4-sonnet-thinking","Yes","277","12","470682","132","471103","0.03"
"2025-09-10T04:55:33.236Z","Included","claude-4-sonnet-thinking","Yes","592","13","470090","180","470875","0.04"
"2025-09-10T04:55:15.671Z","Included","claude-4-sonnet-thinking","Yes","459258","36","10832","219","470345","0.41"
"2025-09-10T04:55:11.100Z","Errored, Not Charged","claude-4-sonnet-thinking","Yes","0","0","0","0","0","0.00"
"2025-09-10T04:54:58.734Z","Included","claude-4-sonnet-thinking","Yes","602","6","470204","1","470813","0.03"
"2025-09-10T04:54:47.262Z","Included","claude-4-sonnet-thinking","Yes","707","6","469497","319","470529","0.04"
"2025-09-10T04:54:37.975Z","Included","claude-4-sonnet-thinking","Yes","538","6","468959","355","469858","0.04"
"2025-09-10T04:54:29.069Z","Included","claude-4-sonnet-thinking","Yes","397","6","468562","251","469216","0.04"
"2025-09-10T04:54:18.595Z","Included","claude-4-sonnet-thinking","Yes","691","7","467871","199","468768","0.04"
"2025-09-10T04:54:09.211Z","Included","claude-4-sonnet-thinking","Yes","386","7","467485","369","468247","0.04"
"2025-09-10T04:54:00.282Z","Included","claude-4-sonnet-thinking","Yes","398","8","467087","202","467695","0.03"
"2025-09-10T04:53:50.485Z","Included","claude-4-sonnet-thinking","Yes","257","395","466830","224","467706","0.03"
"2025-09-10T04:53:42.303Z","Included","claude-4-sonnet-thinking","Yes","460","9","466370","169","467008","0.03"
"2025-09-10T04:53:32.056Z","Included","claude-4-sonnet-thinking","Yes","261","394","466109","133","466897","0.03"
"2025-09-10T04:53:23.394Z","Included","claude-4-sonnet-thinking","Yes","552","11","465557","173","466293","0.03"
"2025-09-10T04:53:08.579Z","Included","claude-4-sonnet-thinking","Yes","2915","382","462642","305","466244","0.04"
"2025-09-10T04:52:58.327Z","Included","claude-4-sonnet-thinking","Yes","980","13","461662","266","462921","0.04"
"2025-09-10T04:52:42.883Z","Included","claude-4-sonnet-thinking","Yes","450830","34","10832","217","461913","0.41"
"2025-09-10T04:51:36.895Z","Included","claude-4-sonnet-thinking","Yes","478","3","461370","638","462489","0.04"
"2025-09-10T04:51:21.195Z","Included","claude-4-sonnet-thinking","Yes","419","3","460951","139","461512","0.03"
"2025-09-10T04:51:08.594Z","Included","claude-4-sonnet-thinking","Yes","411","376","460540","226","461553","0.03"
"2025-09-10T04:50:52.968Z","Included","claude-4-sonnet-thinking","Yes","524","611","460016","144","461295","0.03"
"2025-09-10T04:50:44.695Z","Included","claude-4-sonnet-thinking","Yes","222","384","459794","389","460789","0.03"
"2025-09-10T04:50:36.161Z","Included","claude-4-sonnet-thinking","Yes","255","375","459539","153","460322","0.03"
"2025-09-10T04:50:25.881Z","Included","claude-4-sonnet-thinking","Yes","368","369","459171","186","460094","0.03"
"2025-09-10T04:50:15.741Z","Included","claude-4-sonnet-thinking","Yes","257","392","458914","162","459725","0.03"
"2025-09-10T04:50:07.055Z","Included","claude-4-sonnet-thinking","Yes","380","9","458534","169","459092","0.03"
"2025-09-10T04:49:56.921Z","Included","claude-4-sonnet-thinking","Yes","280","398","458254","133","459065","0.03"
"2025-09-10T04:49:46.430Z","Included","claude-4-sonnet-thinking","Yes","763","11","457491","192","458457","0.03"
"2025-09-10T04:49:32.829Z","Included","claude-4-sonnet-thinking","Yes","3104","11","454387","478","457980","0.04"
"2025-09-10T04:49:21.855Z","Included","claude-4-sonnet-thinking","Yes","875","12","453512","163","454562","0.03"
"2025-09-10T04:49:07.681Z","Included","claude-4-sonnet-thinking","Yes","442680","49","10832","557","454118","0.40"
"2025-09-10T04:48:55.067Z","Errored, Not Charged","claude-4-sonnet-thinking","Yes","0","0","0","0","0","0.00"
"2025-09-10T04:48:36.233Z","Included","claude-4-sonnet-thinking","Yes","454","0","453836","8","454298","0.03"
"2025-09-10T04:48:29.115Z","Included","claude-4-sonnet-thinking","Yes","175","0","453661","127","453963","0.03"
"2025-09-10T04:48:21.873Z","Included","claude-4-sonnet-thinking","Yes","591","0","453070","107","453768","0.03"
"2025-09-10T04:48:11.619Z","Included","claude-4-sonnet-thinking","Yes","432","359","452638","178","453607","0.03"
"2025-09-10T04:48:03.597Z","Included","claude-4-sonnet-thinking","Yes","691","0","451947","131","452769","0.03"
"2025-09-10T04:47:46.440Z","Included","claude-4-sonnet-thinking","Yes","363","374","451584","265","452586","0.03"
"2025-09-10T04:47:33.343Z","Included","claude-4-sonnet-thinking","Yes","323","365","451261","153","452102","0.03"
"2025-09-10T04:47:22.544Z","Included","claude-4-sonnet-thinking","Yes","245","375","451016","226","451862","0.03"
"2025-09-10T04:47:13.126Z","Included","claude-4-sonnet-thinking","Yes","265","380","450751","153","451549","0.03"
"2025-09-10T04:47:03.184Z","Included","claude-4-sonnet-thinking","Yes","570","379","450181","160","451290","0.03"
"2025-09-10T04:46:41.444Z","Included","claude-4-sonnet-thinking","Yes","1026","4","449155","167","450352","0.03"
"2025-09-10T04:46:08.282Z","Included","claude-4-sonnet-thinking","Yes","1769","5","447386","991","450151","0.04"
"2025-09-10T04:45:59.042Z","Included","claude-4-sonnet-thinking","Yes","501","6","446885","1736","449128","0.04"
"2025-09-10T04:45:49.239Z","Included","claude-4-sonnet-thinking","Yes","964","35","445921","264","447184","0.03"
"2025-09-10T04:45:44.301Z","Errored, Not Charged","claude-4-sonnet-thinking","No","0","382","0","10","392","0.000"
"2025-09-10T04:45:31.924Z","Included","claude-4-sonnet-thinking","Yes","567","388","446496","163","447614","0.03"
"2025-09-10T04:45:22.981Z","Included","claude-4-sonnet-thinking","Yes","255","370","446241","174","447040","0.03"
"2025-09-10T04:45:12.362Z","Included","claude-4-sonnet-thinking","Yes","320","375","445921","186","446802","0.03"
"2025-09-10T04:45:05.713Z","Included","claude-4-sonnet-thinking","Yes","1443","30","444478","174","446125","0.03"
"2025-09-10T04:44:08.639Z","Included","claude-4-sonnet-thinking","Yes","342","376","445315","620","446653","0.03"
"2025-09-10T04:43:58.522Z","Included","claude-4-sonnet-thinking","Yes","526","383","444789","191","445889","0.03"
"2025-09-10T04:43:48.658Z","Included","claude-4-sonnet-thinking","Yes","311","384","444478","191","445364","0.03"
"2025-09-10T04:43:32.386Z","Included","claude-4-sonnet-thinking","Yes","444478","27","0","170","444675","0.40"
"2025-09-10T04:25:49.263Z","Included","claude-4-sonnet-thinking","Yes","492","377","452861","1042","454772","0.04"
"2025-09-10T04:25:33.360Z","Included","claude-4-sonnet-thinking","Yes","605","648","452256","258","453767","0.03"
"2025-09-10T04:25:18.505Z","Included","claude-4-sonnet-thinking","Yes","1006","0","451250","444","452700","0.03"
"2025-09-10T04:25:10.844Z","Included","claude-4-sonnet-thinking","Yes","1167","0","450083","510","451760","0.04"
"2025-09-10T04:23:59.522Z","Included","claude-4-sonnet-thinking","Yes","3693","0","446390","121","450204","0.04"
"2025-09-10T04:23:48.054Z","Included","claude-4-sonnet-thinking","Yes","1254","0","445136","3654","450044","0.05"
"2025-09-10T04:23:39.527Z","Included","claude-4-sonnet-thinking","Yes","496","379","444640","315","445830","0.03"
"2025-09-10T04:23:25.259Z","Included","claude-4-sonnet-thinking","Yes","1983","1037","442657","231","445908","0.03"
"2025-09-10T04:22:58.760Z","Included","claude-4-sonnet-thinking","Yes","295","376","442362","1740","444773","0.04"
"2025-09-10T04:22:43.646Z","Included","claude-4-sonnet-thinking","Yes","387","391","441975","227","442980","0.03"
"2025-09-10T04:21:21.364Z","Included","claude-4-sonnet-thinking","Yes","1023","0","440952","151","442126","0.03"
"2025-09-10T04:21:04.098Z","Included","claude-4-sonnet-thinking","Yes","645","0","440307","977","441929","0.04"
"2025-09-10T04:19:57.274Z","Included","claude-4-sonnet-thinking","Yes","5605","0","434702","598","440905","0.04"
"2025-09-10T04:19:08.972Z","Included","claude-4-sonnet-thinking","Yes","3890","0","430812","5564","440266","0.05"
"2025-09-10T04:18:59.459Z","Included","claude-4-sonnet-thinking","Yes","575","0","430237","3848","434660","0.05"
"2025-09-10T04:18:50.305Z","Included","claude-4-sonnet-thinking","Yes","558","0","429679","334","430571","0.03"
"2025-09-10T04:17:18.812Z","Included","claude-4-sonnet-thinking","Yes","7987","0","421692","325","430004","0.04"
"2025-09-10T04:17:02.879Z","Included","claude-4-sonnet-thinking","Yes","1287","0","420405","7951","429643","0.06"
"2025-09-10T04:16:49.695Z","Included","claude-4-sonnet-thinking","Yes","430","375","419975","491","421271","0.03"
"2025-09-10T04:16:25.736Z","Included","claude-4-sonnet-thinking","Yes","1056","994","418919","165","421134","0.03"
"2025-09-10T04:16:11.289Z","Included","claude-4-sonnet-thinking","Yes","420","367","418499","882","420168","0.03"
"2025-09-10T04:15:11.400Z","Included","claude-4-sonnet-thinking","Yes","7244","397","411255","352","419248","0.04"
"2025-09-10T04:14:03.255Z","Included","claude-4-sonnet-thinking","Yes","5699","0","405556","175","411430","0.03"
"2025-09-10T04:12:40.766Z","Included","claude-4-sonnet-thinking","Yes","7321","0","398235","5651","411207","0.06"
"2025-09-10T04:12:31.717Z","Included","claude-4-sonnet-thinking","Yes","546","0","397689","7278","405513","0.06"
"2025-09-10T04:12:23.064Z","Included","claude-4-sonnet-thinking","Yes","531","0","397158","317","398006","0.03"
"2025-09-10T04:10:58.730Z","Included","claude-4-sonnet-thinking","Yes","7037","0","390121","308","397466","0.04"
"2025-09-10T04:10:39.538Z","Included","claude-4-sonnet-thinking","Yes","1175","1946","388946","7822","399889","0.06"
"2025-09-10T04:10:31.272Z","Included","claude-4-sonnet-thinking","Yes","1083","0","387863","184","389130","0.03"
"2025-09-10T04:10:16.727Z","Included","claude-4-sonnet-thinking","Yes","992","0","386871","409","388272","0.03"
"2025-09-10T04:10:07.923Z","Included","claude-4-sonnet-thinking","Yes","489","374","386382","330","387575","0.03"
"2025-09-10T04:09:45.326Z","Included","claude-4-sonnet-thinking","Yes","981","936","385401","226","387544","0.03"
"2025-09-10T04:09:38.334Z","Included","claude-4-sonnet-thinking","Yes","445","367","384956","782","386550","0.03"
"2025-09-10T04:09:17.816Z","Included","claude-4-sonnet-thinking","Yes","10621","395","374335","377","385728","0.04"
"2025-09-10T04:08:26.957Z","Included","claude-4-sonnet-thinking","Yes","3961","0","370374","167","374502","0.03"
"2025-09-10T04:07:09.687Z","Included","claude-4-sonnet-thinking","Yes","6528","0","363846","3915","374289","0.05"
"2025-09-10T04:07:00.906Z","Included","claude-4-sonnet-thinking","Yes","517","0","363329","6487","370333","0.05"
"2025-09-10T04:06:52.742Z","Included","claude-4-sonnet-thinking","Yes","507","0","362822","300","363629","0.03"
"2025-09-10T04:05:33.217Z","Included","claude-4-sonnet-thinking","Yes","7099","0","355723","294","363116","0.03"
"2025-09-10T04:05:18.935Z","Included","claude-4-sonnet-thinking","Yes","902","0","354821","7062","362785","0.05"
"2025-09-10T04:05:09.702Z","Included","claude-4-sonnet-thinking","Yes","497","375","354324","388","355584","0.03"
"2025-09-10T04:04:50.813Z","Included","claude-4-sonnet-thinking","Yes","762","759","353562","235","355318","0.03"
"2025-09-10T04:04:44.256Z","Included","claude-4-sonnet-thinking","Yes","440","364","353122","586","354512","0.03"
"2025-09-10T04:04:24.351Z","Included","claude-4-sonnet-thinking","Yes","13712","395","339410","372","353889","0.04"
"2025-09-10T04:03:18.120Z","Included","claude-4-sonnet-thinking","Yes","5635","0","333775","173","339583","0.03"
"2025-09-10T04:01:56.769Z","Included","claude-4-sonnet-thinking","Yes","7397","0","326378","5588","339363","0.05"
"2025-09-10T04:01:45.348Z","Included","claude-4-sonnet-thinking","Yes","771","0","325607","7355","333733","0.05"
"2025-09-10T04:01:37.295Z","Included","claude-4-sonnet-thinking","Yes","499","374","325108","334","326315","0.02"
"2025-09-10T04:00:25.577Z","Included","claude-4-sonnet-thinking","Yes","766","763","324342","265","326136","0.02"
"2025-09-10T04:00:11.812Z","Included","claude-4-sonnet-thinking","Yes","404","365","323938","601","325308","0.03"
"2025-09-10T03:59:51.838Z","Included","claude-4-sonnet-thinking","Yes","2250","0","321688","326","324264","0.03"
"2025-09-10T03:59:44.440Z","Included","claude-4-sonnet-thinking","Yes","475","0","321213","993","322681","0.03"
"2025-09-10T03:59:37.701Z","Included","claude-4-sonnet-thinking","Yes","2397","0","318816","270","321483","0.03"
"2025-09-10T03:59:31.693Z","Included","claude-4-sonnet-thinking","Yes","433","0","318383","163","318979","0.02"
"2025-09-10T03:59:25.422Z","Included","claude-4-sonnet-thinking","Yes","767","0","317616","148","318531","0.02"
"2025-09-10T03:59:18.963Z","Included","claude-4-sonnet-thinking","Yes","331","0","317285","121","317737","0.02"
"2025-09-10T03:59:13.110Z","Included","claude-4-sonnet-thinking","Yes","165","0","317120","214","317499","0.02"
"2025-09-10T03:58:25.315Z","Included","claude-4-sonnet-thinking","Yes","4077","0","313043","88","317208","0.03"
"2025-09-10T03:58:15.394Z","Included","claude-4-sonnet-thinking","Yes","225","371","312818","4050","317464","0.04"
"2025-09-10T03:58:08.576Z","Included","claude-4-sonnet-thinking","Yes","484","0","312334","128","312946","0.02"
"2025-09-10T03:58:01.416Z","Included","claude-4-sonnet-thinking","Yes","480","0","311854","281","312615","0.02"
"2025-09-10T03:57:55.997Z","Included","claude-4-sonnet-thinking","Yes","354","0","311500","278","312132","0.02"
"2025-09-10T03:56:40.398Z","Included","claude-4-sonnet-thinking","Yes","6778","0","304722","96","311596","0.03"
"2025-09-10T03:56:25.678Z","Included","claude-4-sonnet-thinking","Yes","711","0","304011","6742","311464","0.05"
"2025-09-10T03:56:18.069Z","Included","claude-4-sonnet-thinking","Yes","436","374","303575","289","304674","0.02"
"2025-09-10T03:56:02.078Z","Included","claude-4-sonnet-thinking","Yes","711","713","302864","171","304459","0.02"
"2025-09-10T03:55:55.553Z","Included","claude-4-sonnet-thinking","Yes","474","366","302390","522","303752","0.02"
"2025-09-10T03:55:22.754Z","Included","claude-4-sonnet-thinking","Yes","11884","393","290506","406","303189","0.03"
"2025-09-10T03:54:58.303Z","Included","claude-4-sonnet-thinking","Yes","1050","403","289456","236","291145","0.02"
"2025-09-10T03:54:38.504Z","Included","claude-4-sonnet-thinking","Yes","1351","0","288105","184","289640","0.02"
"2025-09-10T03:54:26.234Z","Included","claude-4-sonnet-thinking","Yes","1808","407","286297","751","289263","0.02"
"2025-09-10T03:53:40.901Z","Included","claude-4-sonnet-thinking","Yes","1378","0","284919","175","286472","0.02"
"2025-09-10T03:53:29.532Z","Included","claude-4-sonnet-thinking","Yes","1521","0","283398","718","285637","0.02"
"2025-09-10T03:53:21.408Z","Errored, Not Charged","claude-4-sonnet-thinking","Yes","479","0","282919","97","283495","0.02"
"2025-09-10T03:53:09.021Z","Included","claude-4-sonnet-thinking","Yes","1820","408","281099","418","283745","0.02"
"2025-09-10T03:52:55.005Z","Included","claude-4-sonnet-thinking","Yes","1751","0","279348","187","281286","0.02"
"2025-09-10T03:52:41.686Z","Included","claude-4-sonnet-thinking","Yes","4128","399","275220","981","280728","0.03"
"2025-09-10T03:52:35.384Z","Included","claude-4-sonnet-thinking","Yes","539","0","274681","171","275391","0.02"
"2025-09-10T03:52:24.466Z","Included","claude-4-sonnet-thinking","Yes","1418","0","273263","232","274913","0.02"
"2025-09-10T03:51:11.175Z","Included","claude-4-sonnet-thinking","Yes","11928","388","261335","702","274353","0.03"
"2025-09-10T03:51:00.227Z","Included","claude-4-sonnet-thinking","Yes","1311","0","260024","153","261488","0.02"
"2025-09-10T03:50:52.722Z","Included","claude-4-sonnet-thinking","Yes","660","0","259364","732","260756","0.02"
"2025-09-10T03:50:42.870Z","Included","claude-4-sonnet-thinking","Yes","1116","0","258248","343","259707","0.02"
"2025-09-10T03:50:24.998Z","Included","claude-4-sonnet-thinking","Yes","11962","402","246286","687","259337","0.03"
"2025-09-10T03:48:44.986Z","Included","claude-4-sonnet-thinking","Yes","7318","0","238968","187","246473","0.02"
"2025-09-10T03:48:38.244Z","Included","claude-4-sonnet-thinking","Yes","526","0","238442","7277","246245","0.04"
"2025-09-10T03:47:43.213Z","Included","claude-4-sonnet-thinking","Yes","542","0","356424","772","357738","0.03"
"2025-09-10T03:47:30.879Z","Included","claude-4-sonnet-thinking","Yes","841","0","355583","167","356591","0.03"
"2025-09-10T03:47:24.570Z","Included","claude-4-sonnet-thinking","Yes","1184","0","354399","427","356010","0.03"
"2025-09-10T03:47:13.871Z","Included","claude-4-sonnet-thinking","Yes","6168","0","232274","180","238622","0.02"
"2025-09-10T03:47:03.013Z","Included","claude-4-sonnet-thinking","Yes","690","0","231584","6123","238397","0.04"
"2025-09-10T03:46:55.615Z","Included","claude-4-sonnet-thinking","Yes","1430","0","352969","115","354514","0.03"
"2025-09-10T03:46:51.064Z","Included","claude-4-sonnet-thinking","Yes","362","470","231222","354","232408","0.02"
"2025-09-10T03:46:45.039Z","Included","claude-4-sonnet-thinking","Yes","376","366","230846","248","231836","0.02"
"2025-09-10T03:46:42.955Z","Included","claude-4-sonnet-thinking","Yes","422","377","352547","1408","354754","0.03"
"2025-09-10T03:46:13.495Z","Included","claude-4-sonnet-thinking","Yes","2873","408","227973","333","231587","0.02"
"2025-09-10T03:46:07.171Z","Included","claude-4-sonnet-thinking","Yes","658","734","351889","152","353433","0.03"
"2025-09-10T03:46:05.207Z","Included","claude-4-sonnet-thinking","Yes","324","408","227649","183","228564","0.02"
"2025-09-10T03:46:00.179Z","Included","claude-4-sonnet-thinking","Yes","208","367","351681","506","352762","0.03"
"2025-09-10T03:45:58.717Z","Included","claude-4-sonnet-thinking","Yes","522","0","227127","171","227820","0.02"
"2025-09-10T03:45:51.859Z","Included","claude-4-sonnet-thinking","Yes","673","0","351008","130","351811","0.03"
"2025-09-10T03:45:50.711Z","Included","claude-4-sonnet-thinking","Yes","647","0","226480","264","227391","0.02"
"2025-09-10T03:45:40.873Z","Included","claude-4-sonnet-thinking","Yes","446","0","226034","363","226843","0.02"
"2025-09-10T03:45:32.655Z","Included","claude-4-sonnet-thinking","Yes","2785","0","223249","225","226259","0.02"
"2025-09-10T03:45:31.836Z","Included","claude-4-sonnet-thinking","Yes","2028","409","348980","322","351739","0.03"
"2025-09-10T03:45:23.512Z","Included","claude-4-sonnet-thinking","Yes","546","0","348434","190","349170","0.03"
"2025-09-10T03:45:18.038Z","Included","claude-4-sonnet-thinking","Yes","1663","0","221586","171","223420","0.02"
"2025-09-10T03:45:15.550Z","Included","claude-4-sonnet-thinking","Yes","597","0","347837","281","348715","0.03"
"2025-09-10T03:45:02.345Z","Included","claude-4-sonnet-thinking","Yes","614","0","347223","342","348179","0.03"
"2025-09-10T03:44:33.299Z","Included","claude-4-sonnet-thinking","Yes","2941","411","218645","956","222953","0.02"
"2025-09-10T03:44:29.272Z","Included","claude-4-sonnet-thinking","Yes","11542","407","335681","461","348091","0.04"
"2025-09-10T03:44:20.102Z","Included","claude-4-sonnet-thinking","Yes","881","1946","217764","734","221325","0.02"
"2025-09-10T03:44:13.083Z","Included","claude-4-sonnet-thinking","Yes","14639","397","321042","377","336455","0.04"
"2025-09-10T03:44:08.627Z","Included","claude-4-sonnet-thinking","Yes","485","0","217279","289","218053","0.02"
"2025-09-10T03:44:04.579Z","Included","claude-4-sonnet-thinking","Yes","727","0","320315","174","321216","0.02"
"2025-09-10T03:43:52.918Z","Included","claude-4-sonnet-thinking","Yes","998","0","319317","347","320662","0.03"
"2025-09-10T03:43:23.247Z","Included","claude-4-sonnet-thinking","Yes","16911","399","302406","769","320485","0.04"
"2025-09-10T03:42:59.184Z","Included","claude-4-sonnet-thinking","Yes","3458","0","213821","250","217529","0.02"
"2025-09-10T03:42:59.008Z","Included","claude-4-sonnet-thinking","Yes","7699","405","294707","460","303271","0.03"
"2025-09-10T03:42:48.095Z","Included","claude-4-sonnet-thinking","Yes","1271","0","293436","171","294878","0.02"
"2025-09-10T03:42:47.987Z","Included","claude-4-sonnet-thinking","Yes","391","0","213430","3422","217243","0.03"
"2025-09-10T03:42:33.989Z","Included","claude-4-sonnet-thinking","Yes","417","375","213013","191","213996","0.02"
"2025-09-10T03:42:27.889Z","Included","claude-4-sonnet-thinking","Yes","7680","400","285756","657","294493","0.03"
"2025-09-10T03:42:23.070Z","Included","claude-4-sonnet-thinking","Yes","456","553","212557","149","213715","0.02"
"2025-09-10T03:42:19.784Z","Included","claude-4-sonnet-thinking","Yes","319","400","285437","175","286331","0.02"
"2025-09-10T03:42:17.261Z","Included","claude-4-sonnet-thinking","Yes","309","363","212248","328","213248","0.02"
"2025-09-10T03:42:13.286Z","Included","claude-4-sonnet-thinking","Yes","436","0","285001","166","285603","0.02"
"2025-09-10T03:42:07.888Z","Included","claude-4-sonnet-thinking","Yes","561","0","211687","231","212479","0.02"
"2025-09-10T03:42:02.802Z","Included","claude-4-sonnet-thinking","Yes","227","0","284774","266","285267","0.02"
"2025-09-10T03:42:00.773Z","Included","claude-4-sonnet-thinking","Yes","621","0","211066","297","211984","0.02"
"2025-09-10T03:41:47.839Z","Included","claude-4-sonnet-thinking","Yes","2943","408","208123","358","211832","0.02"
"2025-09-10T03:41:47.829Z","Included","claude-4-sonnet-thinking","Yes","396","0","284378","163","284937","0.02"
"2025-09-10T03:41:39.796Z","Included","claude-4-sonnet-thinking","Yes","333","410","207790","177","208710","0.02"
"2025-09-10T03:41:33.541Z","Errored, Not Charged","claude-4-sonnet-thinking","Yes","316","2","207474","179","207971","0.02"
"2025-09-10T03:41:28.944Z","Included","claude-4-sonnet-thinking","Yes","532","0","283846","206","284584","0.02"
"2025-09-10T03:41:26.354Z","Included","claude-4-sonnet-thinking","Yes","654","2","206820","245","207721","0.02"
"2025-09-10T03:41:20.908Z","Errored, Not Charged","claude-4-sonnet-thinking","Yes","514","0","283332","152","283998","0.02"
"2025-09-10T03:41:19.568Z","Errored, Not Charged","claude-4-sonnet-thinking","Yes","385","2","206435","305","207127","0.02"
"2025-09-10T03:41:14.718Z","Included","claude-4-sonnet-thinking","Yes","568","0","282764","443","283775","0.02"
"2025-09-10T03:41:13.907Z","Included","claude-4-sonnet-thinking","Yes","314","3","206121","299","206737","0.02"
"2025-09-10T03:41:09.016Z","Included","claude-4-sonnet-thinking","Yes","220","0","282544","152","282916","0.02"
"2025-09-10T03:41:08.095Z","Errored, Not Charged","claude-4-sonnet-thinking","Yes","395","3","205726","132","206256","0.02"
"2025-09-10T03:41:03.985Z","Included","claude-4-sonnet-thinking","Yes","490","0","282054","154","282698","0.02"
"2025-09-10T03:41:00.282Z","Included","claude-4-sonnet-thinking","Yes","361","375","205365","284","206385","0.02"
"2025-09-10T03:40:57.529Z","Included","claude-4-sonnet-thinking","Yes","462","0","281592","155","282209","0.02"
"2025-09-10T03:40:52.983Z","Errored, Not Charged","claude-4-sonnet-thinking","Yes","541","4","204824","156","205525","0.02"
"2025-09-10T03:40:51.395Z","Included","claude-4-sonnet-thinking","Yes","592","0","281000","233","281825","0.02"
"2025-09-10T03:40:48.024Z","Included","claude-4-sonnet-thinking","Yes","555","4","204269","341","205169","0.02"
"2025-09-10T03:40:40.662Z","Errored, Not Charged","claude-4-sonnet-thinking","Yes","454","4","203815","141","204414","0.02"
"2025-09-10T03:40:40.089Z","Included","claude-4-sonnet-thinking","Yes","416","377","280584","387","281764","0.02"
"2025-09-10T03:40:29.310Z","Included","claude-4-sonnet-thinking","Yes","884","4","202931","383","204202","0.02"
"2025-09-10T03:40:25.997Z","Included","claude-4-sonnet-thinking","Yes","539","648","280045","152","281384","0.02"
"2025-09-10T03:39:24.262Z","Included","claude-4-sonnet-thinking","Yes","401","364","279644","418","280827","0.02"
"2025-09-10T03:38:08.084Z","Included","claude-4-sonnet-thinking","Yes","14590","405","188341","551","203887","0.03"
"2025-09-10T03:38:07.774Z","Included","claude-4-sonnet-thinking","Yes","14718","385","264926","333","280362","0.03"
"2025-09-10T03:37:59.930Z","Included","claude-4-sonnet-thinking","Yes","787","6","187554","174","188521","0.01"
"2025-09-10T03:36:52.830Z","Included","claude-4-sonnet-thinking","Yes","493","7","187061","395","187956","0.02"
"2025-09-10T03:36:48.002Z","Included","claude-4-sonnet-thinking","Yes","14592","400","250334","543","265869","0.03"
"2025-09-10T03:36:39.652Z","Included","claude-4-sonnet-thinking","Yes","910","0","249424","177","250511","0.02"
"2025-09-10T03:36:34.456Z","Included","claude-4-sonnet-thinking","Yes","7765","414","179296","247","187722","0.02"
"2025-09-10T03:36:25.791Z","Included","claude-4-sonnet-thinking","Yes","7763","399","241661","453","250276","0.03"
"2025-09-10T03:36:22.642Z","Included","claude-4-sonnet-thinking","Yes","1128","8","178168","175","179479","0.01"
"2025-09-10T03:36:18.355Z","Included","claude-4-sonnet-thinking","Yes","534","0","241127","168","241829","0.02"
"2025-09-10T03:36:12.303Z","Included","claude-4-sonnet-thinking","Yes","514","0","240613","319","241446","0.02"
"2025-09-10T03:36:07.551Z","Included","claude-4-sonnet-thinking","Yes","7753","410","170415","571","179149","0.02"
"2025-09-10T03:36:03.917Z","Included","claude-4-sonnet-thinking","Yes","826","0","239787","226","240839","0.02"
"2025-09-10T03:36:01.177Z","Included","claude-4-sonnet-thinking","Yes","624","9","169791","165","170589","0.01"
"2025-09-10T03:35:56.580Z","Included","claude-4-sonnet-thinking","Yes","385","0","239402","441","240228","0.02"
"2025-09-10T03:35:56.335Z","Included","claude-4-sonnet-thinking","Yes","431","9","169360","330","170130","0.01"
"2025-09-10T03:35:49.233Z","Errored, Not Charged","claude-4-sonnet-thinking","Yes","445","9","168915","135","169504","0.01"
"2025-09-10T03:35:49.200Z","Included","claude-4-sonnet-thinking","Yes","736","0","238666","169","239571","0.02"
"2025-09-10T03:35:43.539Z","Included","claude-4-sonnet-thinking","Yes","319","9","168596","329","169253","0.01"
"2025-09-10T03:35:16.614Z","Included","claude-4-sonnet-thinking","Yes","443","9","168153","150","168755","0.01"
"2025-09-10T03:34:37.042Z","Included","claude-4-sonnet-thinking","Yes","8387","394","159766","253","168800","0.02"
"2025-09-10T03:34:36.708Z","Included","claude-4-sonnet-thinking","Yes","8355","382","230311","536","239584","0.03"
"2025-09-10T03:34:24.434Z","Included","claude-4-sonnet-thinking","Yes","943","409","158823","227","160402","0.01"
"2025-09-10T03:34:15.987Z","Included","claude-4-sonnet-thinking","Yes","551","11","158272","189","159023","0.01"
"2025-09-10T03:34:11.297Z","Included","claude-4-sonnet-thinking","Yes","544","1","229767","173","230485","0.02"
"2025-09-10T03:34:06.933Z","Errored, Not Charged","claude-4-sonnet-thinking","Yes","0","0","0","0","0","0.00"
"2025-09-10T03:34:06.411Z","Included","claude-4-sonnet-thinking","Yes","1053","95","157219","410","158777","0.01"
"2025-09-10T03:33:55.060Z","Errored, Not Charged","claude-4-sonnet-thinking","Yes","645","12","157862","148","158667","0.01"
"2025-09-10T03:33:49.814Z","Included","claude-4-sonnet-thinking","Yes","925","396","228842","241","230404","0.02"
"2025-09-10T03:33:47.402Z","Included","claude-4-sonnet-thinking","Yes","643","12","157219","574","158448","0.01"
"2025-09-10T03:33:40.376Z","Included","claude-4-sonnet-thinking","Yes","832","2","228010","165","229009","0.02"
"2025-09-10T03:33:38.708Z","Included","claude-4-sonnet-thinking","Yes","146387","43","10832","310","157572","0.13"
"2025-09-10T03:33:32.703Z","Included","claude-4-sonnet-thinking","Yes","539","2","227471","510","228522","0.02"
"2025-09-10T03:33:02.303Z","Included","claude-4-sonnet-thinking","Yes","186","2","227285","129","227602","0.02"
"2025-09-10T03:32:57.643Z","Included","claude-4-sonnet-thinking","Yes","161","3","227124","149","227437","0.02"
"2025-09-10T03:32:52.312Z","Included","claude-4-sonnet-thinking","Yes","183","4","226941","124","227252","0.02"
"2025-09-10T03:32:47.746Z","Included","claude-4-sonnet-thinking","Yes","469","5","226472","146","227092","0.02"
"2025-09-10T03:32:42.487Z","Included","claude-4-sonnet-thinking","Yes","584","5","225888","140","226617","0.02"
"2025-09-10T03:32:13.097Z","Included","claude-4-sonnet-thinking","Yes","1851","400","224037","269","226557","0.02"
"2025-09-10T03:32:04.773Z","Included","claude-4-sonnet-thinking","Yes","734","6","223303","164","224207","0.02"
"2025-09-10T03:31:57.018Z","Included","claude-4-sonnet-thinking","Yes","608","6","222695","403","223712","0.02"
"2025-09-10T03:31:46.555Z","Included","claude-4-sonnet-thinking","Yes","1045","6","221650","350","223051","0.02"
"2025-09-10T03:31:01.111Z","Included","claude-4-sonnet-thinking","Yes","4701","398","216949","676","222724","0.02"
"2025-09-10T03:30:53.041Z","Included","claude-4-sonnet-thinking","Yes","876","7","216073","159","217115","0.02"
"2025-09-10T03:30:44.377Z","Included","claude-4-sonnet-thinking","Yes","916","7","215157","462","216542","0.02"
"2025-09-10T03:30:34.172Z","Included","claude-4-sonnet-thinking","Yes","968","7","214189","481","215645","0.02"
"2025-09-10T03:30:27.571Z","Included","claude-4-sonnet-thinking","Yes","608","7","213581","530","214726","0.02"
"2025-09-10T03:30:20.251Z","Included","claude-4-sonnet-thinking","Yes","717","7","212864","322","213910","0.02"
"2025-09-10T03:28:49.604Z","Included","claude-4-sonnet-thinking","Yes","12923","404","199941","467","213735","0.03"
"2025-09-10T03:28:40.499Z","Included","claude-4-sonnet-thinking","Yes","746","8","199195","166","200115","0.02"
"2025-09-10T03:28:32.072Z","Included","claude-4-sonnet-thinking","Yes","875","8","198320","424","199627","0.02"
"2025-09-10T03:28:24.784Z","Included","claude-4-sonnet-thinking","Yes","299","8","198021","473","198801","0.02"
"2025-09-10T03:28:19.523Z","Included","claude-4-sonnet-thinking","Yes","409","8","197612","195","198224","0.02"
"2025-09-10T03:28:10.031Z","Included","claude-4-sonnet-thinking","Yes","909","8","196703","211","197831","0.02"
"2025-09-10T03:25:23.504Z","Included","claude-4-sonnet-thinking","Yes","12662","401","184041","575","197679","0.03"
"2025-09-10T03:25:14.858Z","Included","claude-4-sonnet-thinking","Yes","744","9","183297","162","184212","0.01"
"2025-09-10T03:25:07.874Z","Included","claude-4-sonnet-thinking","Yes","451","9","182846","406","183712","0.02"
"2025-09-10T03:25:00.660Z","Included","claude-4-sonnet-thinking","Yes","731","9","182115","238","183093","0.01"
"2025-09-10T03:24:54.500Z","Errored, Not Charged","claude-4-sonnet-thinking","Yes","321","9","181794","397","182521","0.01"
"2025-09-10T03:24:30.188Z","Included","claude-4-sonnet-thinking","Yes","1247","10","180547","235","182039","0.01"
"2025-09-10T03:24:09.703Z","Included","claude-4-sonnet-thinking","Yes","793","10","179754","757","181314","0.02"
"2025-09-10T03:24:00.915Z","Included","claude-4-sonnet-thinking","Yes","692","10","179062","459","180223","0.02"
"2025-09-10T03:23:44.738Z","Included","claude-4-sonnet-thinking","Yes","1403","10","177659","398","179470","0.02"
"2025-09-10T03:23:35.169Z","Included","claude-4-sonnet-thinking","Yes","715","10","176944","824","178493","0.02"
"2025-09-10T03:20:30.002Z","Included","claude-4-sonnet-thinking","Yes","13344","408","163600","403","177755","0.03"
"2025-09-10T03:20:24.186Z","Included","claude-4-sonnet-thinking","Yes","469","11","163131","171","163782","0.01"
"2025-09-10T03:20:18.074Z","Included","claude-4-sonnet-thinking","Yes","484","11","162647","218","163360","0.01"
"2025-09-10T03:20:09.397Z","Included","claude-4-sonnet-thinking","Yes","825","11","161822","256","162914","0.01"
"2025-09-10T03:19:59.788Z","Included","claude-4-sonnet-thinking","Yes","670","12","161152","436","162270","0.01"
"2025-09-10T03:19:43.864Z","Included","claude-4-sonnet-thinking","Yes","1921","12","159231","348","161512","0.01"
"2025-09-10T03:19:32.086Z","Included","claude-4-sonnet-thinking","Yes","1320","12","157911","1114","160357","0.02"
"2025-09-10T03:19:24.187Z","Included","claude-4-sonnet-thinking","Yes","692","12","157219","777","158700","0.01"
"2025-09-10T03:19:13.274Z","Included","claude-4-sonnet-thinking","Yes","146387","43","10832","354","157616","0.13"
"2025-09-10T03:17:01.727Z","Included","claude-4-sonnet-thinking","Yes","1766","3","156024","532","158325","0.01"
"2025-09-10T03:16:39.855Z","Included","claude-4-sonnet-thinking","Yes","416","4","155608","1732","157760","0.02"
"2025-09-10T03:16:33.908Z","Included","claude-4-sonnet-thinking","Yes","2987","4","152621","142","155754","0.01"
"2025-09-10T03:16:29.198Z","Included","claude-4-sonnet-thinking","Yes","5008","4","147613","106","152731","0.02"
"2025-09-10T03:16:23.993Z","Included","claude-4-sonnet-thinking","Yes","160","4","147453","99","147716","0.01"
"2025-09-10T03:16:09.822Z","Included","claude-4-sonnet-thinking","Yes","485","1627","146968","410","149490","0.01"
"2025-09-10T03:15:57.460Z","Included","claude-4-sonnet-thinking","Yes","744","1627","146224","416","149011","0.01"
"2025-09-10T03:15:42.795Z","Included","claude-4-sonnet-thinking","Yes","416","4","145808","402","146630","0.01"
"2025-09-10T03:15:37.465Z","Included","claude-4-sonnet-thinking","Yes","371","376","145437","154","146338","0.01"
"2025-09-10T03:15:28.151Z","Included","claude-4-sonnet-thinking","Yes","309","393","145128","302","146132","0.01"
"2025-09-10T03:15:21.474Z","Included","claude-4-sonnet-thinking","Yes","1934","6","143194","230","145364","0.01"
"2025-09-10T03:15:15.354Z","Included","claude-4-sonnet-thinking","Yes","263","370","142931","152","143716","0.01"
"2025-09-10T03:15:08.330Z","Included","claude-4-sonnet-thinking","Yes","265","380","142666","194","143505","0.01"
"2025-09-10T03:15:02.307Z","Included","claude-4-sonnet-thinking","Yes","287","381","142379","153","143200","0.01"
"2025-09-10T03:14:54.796Z","Included","claude-4-sonnet-thinking","Yes","783","9","141596","208","142596","0.01"
"2025-09-10T03:14:48.906Z","Included","claude-4-sonnet-thinking","Yes","234","9","141362","179","141784","0.01"
"2025-09-10T03:14:42.704Z","Included","claude-4-sonnet-thinking","Yes","611","34","140751","143","141539","0.01"
"2025-09-10T03:14:42.495Z","Errored, Not Charged","claude-4-sonnet-thinking","No","0","364","0","10","374","0.000"
"2025-09-10T03:14:34.699Z","Included","claude-4-sonnet-thinking","Yes","245","374","141360","217","142196","0.01"
"2025-09-10T03:14:27.140Z","Included","claude-4-sonnet-thinking","Yes","245","381","141115","176","141917","0.01"
"2025-09-10T03:14:19.280Z","Included","claude-4-sonnet-thinking","Yes","364","372","140751","168","141655","0.01"
"2025-09-10T03:14:10.624Z","Errored, Not Charged","claude-4-sonnet-thinking","No","0","369","0","10","379","0.000"
"2025-09-10T03:14:08.466Z","Included","claude-4-sonnet-thinking","Yes","129919","44","10832","245","141040","0.12"
"2025-09-10T03:14:04.864Z","Included","claude-4-sonnet-thinking","Yes","577","7","140881","175","141640","0.01"
"2025-09-10T03:14:00.951Z","Included","claude-4-sonnet-thinking","Yes","861","8","140020","122","141011","0.01"
"2025-09-10T03:13:56.198Z","Included","claude-4-sonnet-thinking","Yes","510","8","139510","134","140162","0.01"
"2025-09-10T03:13:52.016Z","Included","claude-4-sonnet-thinking","Yes","187","8","139323","110","139628","0.01"
"2025-09-10T03:13:47.512Z","Included","claude-4-sonnet-thinking","Yes","1443","8","137880","108","139439","0.01"
"2025-09-10T03:13:42.058Z","Included","claude-4-sonnet-thinking","Yes","1236","8","136644","146","138034","0.01"
"2025-09-10T03:13:37.776Z","Included","claude-4-sonnet-thinking","Yes","918","8","135726","123","136775","0.01"
"2025-09-10T03:13:31.599Z","Included","claude-4-sonnet-thinking","Yes","231","371","135495","108","136205","0.01"
"2025-09-10T03:13:24.828Z","Included","claude-4-sonnet-thinking","Yes","234","372","135261","154","136021","0.01"
"2025-09-10T03:13:19.376Z","Included","claude-4-sonnet-thinking","Yes","508","10","134753","145","135416","0.01"
"2025-09-10T03:13:14.188Z","Included","claude-4-sonnet-thinking","Yes","1615","10","133138","242","135005","0.01"
"2025-09-10T03:13:09.509Z","Included","claude-4-sonnet-thinking","Yes","304","10","132834","103","133251","0.01"
"2025-09-10T03:13:05.718Z","Errored, Not Charged","claude-4-sonnet-thinking","No","0","386","0","10","396","0.000"
"2025-09-10T03:13:01.680Z","Included","claude-4-sonnet-thinking","Yes","1350","35","131484","213","133082","0.01"
"2025-09-10T03:12:56.980Z","Errored, Not Charged","claude-4-sonnet-thinking","Yes","222","389","132993","189","133793","0.01"
"2025-09-10T03:12:50.228Z","Included","claude-4-sonnet-thinking","Yes","502","383","132491","202","133578","0.01"
"2025-09-10T03:12:44.091Z","Included","claude-4-sonnet-thinking","Yes","323","377","132168","166","133034","0.01"
"2025-09-10T03:12:38.357Z","Included","claude-4-sonnet-thinking","Yes","228","370","131940","147","132685","0.01"
"2025-09-10T03:12:28.831Z","Included","claude-4-sonnet-thinking","Yes","456","502","131484","137","132579","0.01"
"2025-09-10T03:12:21.952Z","Included","claude-4-sonnet-thinking","Yes","120652","54","10832","313","131851","0.11"
"2025-09-10T03:12:12.501Z","Errored, Not Charged","claude-4-sonnet-thinking","No","0","400","0","10","410","0.000"
"2025-09-10T03:12:07.716Z","Included","claude-4-sonnet-thinking","Yes","259","362","135789","170","136580","0.01"
"2025-09-10T03:11:59.721Z","Included","claude-4-sonnet-thinking","Yes","630","0","135159","179","135968","0.01"
"2025-09-10T03:10:39.786Z","Included","claude-4-sonnet-thinking","Yes","13388","395","121771","423","135977","0.02"
"2025-09-10T03:10:32.202Z","Included","claude-4-sonnet-thinking","Yes","336","0","121435","166","121937","0.01"
"2025-09-10T03:10:23.233Z","Included","claude-4-sonnet-thinking","Yes","508","0","120927","325","121760","0.01"
"2025-09-10T03:10:11.932Z","Included","claude-4-sonnet-thinking","Yes","1228","0","119699","258","121185","0.01"
"2025-09-10T03:10:03.797Z","Included","claude-4-sonnet-thinking","Yes","1063","0","118636","694","120393","0.01"
"2025-09-10T03:09:57.121Z","Included","claude-4-sonnet-thinking","Yes","892","0","117744","560","119196","0.01"
"2025-09-10T03:08:49.747Z","Included","claude-4-sonnet-thinking","Yes","13312","389","104432","580","118713","0.02"
"2025-09-10T03:08:40.368Z","Included","claude-4-sonnet-thinking","Yes","950","0","103482","188","104620","0.01"
"2025-09-10T03:08:32.259Z","Included","claude-4-sonnet-thinking","Yes","410","0","103072","563","104045","0.01"
"2025-09-10T03:08:27.789Z","Included","claude-4-sonnet-thinking","Yes","1602","0","101470","174","103246","0.01"
"2025-09-10T03:08:21.916Z","Included","claude-4-sonnet-thinking","Yes","1378","0","100092","185","101655","0.01"
"2025-09-10T03:08:14.614Z","Included","claude-4-sonnet-thinking","Yes","1422","0","98670","146","100238","0.01"
"2025-09-10T03:07:58.298Z","Included","claude-4-sonnet-thinking","Yes","705","0","97965","1152","99822","0.01"
"2025-09-10T03:07:48.350Z","Included","claude-4-sonnet-thinking","Yes","1369","0","96596","373","98338","0.01"
"2025-09-10T03:07:40.723Z","Included","claude-4-sonnet-thinking","Yes","991","0","95605","761","97357","0.01"
"2025-09-10T03:07:34.753Z","Included","claude-4-sonnet-thinking","Yes","659","0","94946","528","96133","0.01"
"2025-09-10T03:07:28.547Z","Included","claude-4-sonnet-thinking","Yes","692","0","94254","348","95294","0.01"
"2025-09-10T03:07:13.084Z","Included","claude-4-sonnet-thinking","Yes","837","0","93417","372","94626","0.01"
"2025-09-10T03:07:05.281Z","Included","claude-4-sonnet-thinking","Yes","897","0","92520","429","93846","0.01"
"2025-09-10T03:06:59.544Z","Included","claude-4-sonnet-thinking","Yes","617","0","91903","497","93017","0.01"
"2025-09-10T03:06:53.840Z","Included","claude-4-sonnet-thinking","Yes","542","0","91361","332","92235","0.01"
"2025-09-10T03:06:44.067Z","Included","claude-4-sonnet-thinking","Yes","1010","0","90351","314","91675","0.01"
"2025-09-10T03:06:36.315Z","Included","claude-4-sonnet-thinking","Yes","421","1","89930","635","90987","0.01"
"2025-09-10T03:06:31.462Z","Included","claude-4-sonnet-thinking","Yes","272","1","89658","147","90078","0.01"
"2025-09-10T03:06:27.497Z","Included","claude-4-sonnet-thinking","Yes","284","2","89374","123","89783","0.01"
"2025-09-10T03:06:21.504Z","Included","claude-4-sonnet-thinking","Yes","1505","3","87869","247","89624","0.01"
"2025-09-10T03:05:40.295Z","Included","claude-4-sonnet-thinking","Yes","14760","375","73109","339","88583","0.02"
"2025-09-10T03:05:29.484Z","Included","claude-4-sonnet-thinking","Yes","931","394","72178","203","73706","0.01"
"2025-09-10T03:05:23.821Z","Included","claude-4-sonnet-thinking","Yes","327","390","71851","171","72739","0.01"
"2025-09-10T03:05:12.566Z","Included","claude-4-sonnet-thinking","Yes","1193","6","70658","173","72030","0.01"
"2025-09-10T03:05:03.505Z","Included","claude-4-sonnet-thinking","Yes","693","398","69965","760","71816","0.01"
"2025-09-10T03:04:46.189Z","Included","claude-4-sonnet-thinking","Yes","1308","396","68657","372","70733","0.01"
"2025-09-10T03:04:38.863Z","Included","claude-4-sonnet-thinking","Yes","659","8","67998","172","68837","0.01"
"2025-09-10T03:04:26.874Z","Included","claude-4-sonnet-thinking","Yes","1564","8","66434","357","68363","0.01"
"2025-09-10T03:04:09.574Z","Included","claude-4-sonnet-thinking","Yes","11804","397","54630","955","67786","0.02"
"2025-09-10T03:04:01.438Z","Included","claude-4-sonnet-thinking","Yes","1023","9","53607","175","54814","0.01"
"2025-09-10T03:03:53.464Z","Included","claude-4-sonnet-thinking","Yes","764","9","52843","565","54181","0.01"
"2025-09-10T03:03:42.903Z","Included","claude-4-sonnet-thinking","Yes","1088","9","51755","412","53264","0.01"
"2025-09-10T03:03:35.932Z","Included","claude-4-sonnet-thinking","Yes","722","9","51033","591","52355","0.01"
"2025-09-10T03:03:21.227Z","Included","claude-4-sonnet-thinking","Yes","1480","9","49553","397","51439","0.01"
"2025-09-10T03:03:08.611Z","Included","claude-4-sonnet-thinking","Yes","1309","9","48244","787","50349","0.01"
"2025-09-10T03:02:55.073Z","Included","claude-4-sonnet-thinking","Yes","1486","9","46758","736","48989","0.01"
"2025-09-10T03:02:48.297Z","Included","claude-4-sonnet-thinking","Yes","544","9","46214","910","47677","0.01"
"2025-09-10T03:02:40.904Z","Included","claude-4-sonnet-thinking","Yes","839","9","45375","293","46516","0.01"
"2025-09-10T03:02:29.081Z","Included","claude-4-sonnet-thinking","Yes","4797","9","40578","577","45961","0.01"
"2025-09-10T03:01:48.696Z","Included","claude-4-sonnet-thinking","Yes","11616","380","28962","250","41208","0.01"
"2025-09-10T03:01:26.047Z","Included","claude-4-sonnet-thinking","Yes","1498","373","27464","153","29488","0.004"
"2025-09-10T03:01:15.442Z","Included","claude-4-sonnet-thinking","Yes","435","393","27029","159","28016","0.003"
"2025-09-10T03:01:07.657Z","Included","claude-4-sonnet-thinking","Yes","12431","13","14598","283","27325","0.01"
"2025-09-10T03:01:07.052Z","Included","claude-4-sonnet-thinking","Yes","0","0","0","0","0","0.00"
"2025-09-10T03:01:06.632Z","Included","claude-4-sonnet-thinking","Yes","0","0","0","0","0","0.00"
"2025-09-10T03:00:58.512Z","Included","claude-4-sonnet-thinking","Yes","3766","9","10832","422","15029","0.01"
"2025-09-10T02:55:55.371Z","Included","auto","No","104835","0","5542673","13221","5660729","1.54"
"2025-09-10T01:53:46.926Z","Errored, Not Charged","auto","No","326708","117784","5638279","22839","6105610","1.84"
"2025-09-09T23:28:40.882Z","Included","auto","No","260709","174632","12326614","62191","12824146","3.61"
"2025-09-09T23:26:36.146Z","Included","auto","No","52733","0","245669","1160","299562","0.12"
"2025-09-09T23:24:10.521Z","Errored, Not Charged","auto","No","49764","0","7281","503","57548","0.05"
"2025-09-09T23:11:48.415Z","Included","auto","No","33226","0","1996828","34616","2064670","0.67"
"2025-09-09T23:09:05.945Z","Errored, Not Charged","auto","No","5891","0","538435","2294","546620","0.15"
"2025-09-09T23:08:57.912Z","Errored, Not Charged","auto","No","757","0","69899","80","70736","0.02"
"2025-09-09T23:07:14.647Z","Errored, Not Charged","auto","No","27517","99646","7129","10455","144747","0.08"
"2025-09-09T23:04:10.410Z","Errored, Not Charged","auto","No","1394","0","216389","410","218193","0.06"
"2025-09-09T23:02:12.101Z","Errored, Not Charged","auto","No","8746","0","1248929","846","1258521","0.32"
"2025-09-09T23:01:28.231Z","Errored, Not Charged","auto","No","8245","0","657298","1112","666655","0.18"
"2025-09-09T23:00:43.226Z","Errored, Not Charged","auto","No","27446","0","402099","949","430494","0.13"
"2025-09-09T22:50:41.390Z","Errored, Not Charged","auto","No","88353","71261","2178641","25244","2363499","0.74"
"2025-09-09T22:48:21.475Z","Included","auto","No","11030","0","654097","1302","666429","0.18"
"2025-09-09T22:44:30.956Z","Included","auto","No","13763","0","139801","233","153797","0.05"
"2025-09-09T22:35:53.014Z","Errored, Not Charged","auto","No","67602","0","1213300","3121","1284023","0.38"
"2025-09-09T22:27:57.250Z","Included","auto","No","0","0","0","0","0","0.00"
"2025-09-09T22:25:21.251Z","Included","auto","No","37464","0","2265217","3653","2306334","0.62"
"2025-09-09T22:17:11.830Z","Included","auto","No","101840","218","3418184","6449","3526691","1.45"
"2025-09-09T22:15:02.100Z","Included","auto","No","47458","0","1673721","1506","1722685","0.47"
"2025-09-09T22:05:39.471Z","Included","auto","No","161333","36058","3189106","21040","3407537","1.04"
"2025-09-09T21:52:28.188Z","Included","auto","No","75542","0","4025570","5339","4106451","1.10"
"2025-09-09T21:47:17.307Z","Included","auto","No","35535","96080","260998","12396","405009","0.16"
"2025-09-09T21:36:10.931Z","Included","auto","No","34141","0","2764387","6318","2804846","0.75"
"2025-09-09T21:27:26.795Z","Included","auto","No","14387","0","2173566","4794","2192747","0.58"
"2025-09-09T21:23:03.536Z","Errored, Not Charged","auto","No","51003","0","1109349","4850","1165202","0.35"
"2025-09-09T21:14:05.802Z","Included","auto","No","154627","17169","2665315","15662","2852773","0.88"
"2025-09-09T21:01:14.551Z","Included","auto","No","178863","0","6325439","9041","6513343","1.80"
"2025-09-09T20:57:21.245Z","Errored, Not Charged","auto","No","15370","857223","7281","10957","890831","0.18"
"2025-09-09T20:51:30.287Z","Included","auto","No","101071","22606","555862","11176","690715","0.28"
"2025-09-09T20:44:21.825Z","Errored, Not Charged","auto","No","147613","0","2043284","3505","2194402","0.67"
"2025-09-09T20:38:48.597Z","Errored, Not Charged","auto","No","103711","0","2058977","4827","2167515","0.64"
"2025-09-09T20:30:47.768Z","Errored, Not Charged","auto","No","99066","62285","1779209","12777","1953337","0.60"
"2025-09-09T20:28:48.948Z","Errored, Not Charged","auto","No","57554","0","985265","5711","1048530","0.33"
"2025-09-09T20:18:19.124Z","Included","auto","No","56689","0","1294598","3056","1354343","0.39"
"2025-09-09T20:14:44.409Z","Errored, Not Charged","auto","No","84970","0","21119","55","106144","0.09"
"2025-09-09T20:09:18.264Z","Included","auto","No","97384","104698","1505880","13705","1721667","0.54"
"2025-09-09T20:07:04.803Z","Included","auto","No","2966","0","1003750","1547","1008263","0.26"
"2025-09-09T20:05:35.080Z","Errored, Not Charged","auto","No","102827","0","329108","731","432666","0.19"
"2025-09-09T19:22:09.103Z","Included","auto","No","62123","0","2757410","11987","2831520","0.80"
"2025-09-09T19:19:54.111Z","Errored, Not Charged","auto","No","20170","0","9134","200","29504","0.02"
"2025-09-09T19:18:40.727Z","Included","auto","No","17021","0","9878","627","27526","0.02"
"2025-09-09T19:13:28.174Z","Errored, Not Charged","auto","No","139479","772253","738699","17467","1667898","0.50"
"2025-09-09T19:06:40.831Z","Included","auto","No","117843","0","1503072","3850","1624765","0.51"
"2025-09-09T19:00:42.805Z","Errored, Not Charged","auto","No","198146","0","1041662","2796","1242604","0.47"
"2025-09-09T16:29:24.494Z","Included","auto","No","574671","169015","9977856","73069","10794611","5.90"
"2025-09-09T16:16:32.955Z","Included","auto","No","74961","146","4647452","13936","4736495","1.88"
"2025-09-09T15:28:03.164Z","Errored, Not Charged","auto","No","59003","119260","7571263","21571","7771097","2.69"
"2025-09-09T15:25:18.170Z","Included","auto","No","3106","177","780066","856","784205","0.26"
"2025-09-09T15:18:38.682Z","Included","auto","No","10949","121","1786525","2856","1800451","0.62"
"2025-09-09T15:17:37.515Z","Errored, Not Charged","auto","No","2576","188","569290","651","572705","0.19"
"2025-09-09T15:15:55.887Z","Errored, Not Charged","auto","No","6002","162","1379599","3391","1389154","0.49"
"2025-09-09T15:14:13.333Z","Errored, Not Charged","auto","No","4843","173","658706","752","664474","0.23"
"2025-09-09T15:13:28.453Z","Errored, Not Charged","auto","No","5089","407","380330","683","386509","0.14"
"2025-09-09T14:58:17.788Z","Included","auto","No","60240","119","3794978","10205","3865542","1.52"
"2025-09-09T14:56:42.390Z","Errored, Not Charged","auto","No","2288","129","188686","470","191573","0.07"
"2025-09-09T14:49:16.947Z","Errored, Not Charged","auto","No","51534","2259","702359","3720","759872","0.46"
"2025-09-09T14:34:37.222Z","Included","auto","No","177856","116","5040495","6810","5225277","2.28"
"2025-09-09T14:32:42.155Z","Errored, Not Charged","auto","No","8085","119","549788","7805","565797","0.31"
"2025-09-09T14:28:36.627Z","Included","auto","No","20557","4136","1022388","1676","1048757","0.42"
"2025-09-09T14:23:41.010Z","Included","auto","No","102820","5283","1425518","4779","1538400","0.90"
"2025-09-09T13:23:51.304Z","Included","auto","No","85468","145","2206822","7476","2299911","1.10"
"2025-09-09T11:21:28.123Z","Included","auto","No","30534","797352","10922","11913","850721","0.29"
"2025-09-09T11:16:49.284Z","Included","auto","No","17318","4058","1488151","2712","1512239","0.56"
"2025-09-09T11:03:38.107Z","Included","auto","No","318693","50378","6438953","32578","6840602","3.53"
"2025-09-09T11:02:27.959Z","Errored, Not Charged","auto","No","4158","119","497224","1940","503441","0.19"
"2025-09-09T11:00:42.336Z","Errored, Not Charged","auto","No","70179","110","10922","170","81381","0.27"
"2025-09-09T10:52:29.493Z","Errored, Not Charged","auto","No","260","114","80399","233","81006","0.03"
"2025-09-09T10:51:50.418Z","Errored, Not Charged","auto","No","1431","114","477005","921","479471","0.16"
"2025-09-09T10:50:33.657Z","Included","auto","No","3176","119","386208","1472","390975","0.15"
"2025-09-09T10:49:30.004Z","Errored, Not Charged","auto","No","1175","112","224865","657","226809","0.08"
"2025-09-09T10:46:10.935Z","Included","auto","No","5834","109","142993","402","149338","0.07"
"2025-09-09T10:44:52.614Z","Errored, Not Charged","auto","No","515","156","68268","5201","74140","0.10"
"2025-09-09T10:43:11.131Z","Errored, Not Charged","auto","No","6120","108","391837","1696","399761","0.17"
"2025-09-09T10:42:26.888Z","Included","auto","No","1346","116","183787","540","185789","0.07"
"2025-09-09T10:42:18.069Z","Errored, Not Charged","auto","No","1168","117","59634","216","61135","0.03"
"2025-09-09T10:39:02.394Z","Errored, Not Charged","auto","No","48712","156","621124","3245","673237","0.42"
"2025-09-09T10:36:53.116Z","Errored, Not Charged","auto","No","38262","114732","10922","20694","184610","0.27"
"2025-09-09T10:31:55.427Z","Included","auto","No","17170","408","2630208","5522","2653308","0.94"
"2025-09-09T10:30:09.013Z","Errored, Not Charged","auto","No","3895","414","1074475","2642","1081426","0.38"
"2025-09-09T10:27:52.955Z","Errored, Not Charged","auto","No","6673","379","1335258","3943","1346253","0.49"
"2025-09-09T10:21:37.854Z","Included","auto","No","12655","156","2954400","3866","2971077","0.99"
"2025-09-09T10:15:43.179Z","Included","auto","No","21886","158","1119991","8716","1150751","0.55"
"2025-09-09T09:57:12.339Z","Errored, Not Charged","auto","No","108068","346","1919003","8124","2035541","1.10"
"2025-09-09T09:53:08.752Z","Errored, Not Charged","auto","No","13849","446","2838189","5226","2857710","0.98"
"2025-09-09T09:42:26.400Z","Errored, Not Charged","auto","No","21642","241","2964180","6976","2993039","1.08"
"2025-09-09T09:39:19.449Z","Errored, Not Charged","auto","No","54408","164","1033590","5792","1093954","0.60"
"2025-09-09T09:36:49.808Z","Included","auto","No","15059","789334","10922","12348","827663","0.23"
"2025-09-09T09:36:06.202Z","Included","auto","No","330","125","49062","364","49881","0.02"
"2025-09-09T09:34:10.874Z","Included","auto","No","38140","131662","153588","13851","337241","0.27"
"2025-09-09T09:24:06.378Z","Errored, Not Charged","auto","No","22967","181","7654239","7806","7685193","2.50"
"2025-09-09T08:59:06.118Z","Errored, Not Charged","auto","No","326295","24497","9925756","22966","10299514","4.43"
"2025-09-09T08:44:08.861Z","Included","auto","No","205164","275","9712474","14164","9932077","3.90"
"2025-09-09T08:24:17.927Z","Included","auto","No","440153","65298","10038607","17071","10561129","4.86"
"2025-09-09T08:16:10.813Z","Included","auto","No","119782","230","3893521","20619","4034152","1.93"
"2025-09-09T07:54:14.461Z","Errored, Not Charged","auto","No","406510","123570","10351784","32417","10914281","4.98"
"2025-09-09T00:12:30.880Z","Included","auto","No","9185","4027","639633","4546","657391","0.31"
"2025-09-09T00:08:05.837Z","Errored, Not Charged","auto","No","144577","4016","161574","670","310837","0.61"
"2025-09-09T00:07:24.019Z","Included","auto","No","95","29","34665","56","34845","0.01"
"2025-09-09T00:06:39.437Z","Included","auto","No","23743","62","170476","572","194853","0.15"
"2025-09-09T00:05:24.286Z","Included","auto","No","18370","123472","10922","3368","156132","0.10"
"2025-09-09T00:02:21.545Z","Included","auto","No","135370","4008","10922","349","150649","0.53"
"2025-09-08T23:50:05.667Z","Included","auto","No","10738","4004","1553595","3513","1571850","0.57"
"2025-09-08T23:42:29.265Z","Included","auto","No","13584","4011","515145","4331","537071","0.28"
"2025-09-08T23:39:11.629Z","Included","auto","No","110581","4003","10922","573","126079","0.44"
"2025-09-08T23:17:44.898Z","Included","auto","No","6577","4208","348209","1961","360955","0.17"
"2025-09-08T23:13:38.525Z","Included","auto","No","12548","4014","1399900","4011","1420473","0.54"
"2025-09-08T23:12:30.123Z","Included","auto","No","90344","4013","308242","1030","403629","0.46"
"2025-09-08T22:33:41.863Z","Included","auto","No","7628","4012","270390","3138","285168","0.17"
"2025-09-08T22:31:58.683Z","Included","auto","No","76584","3946","353552","1049","435131","0.42"
"2025-09-08T22:03:38.231Z","Included","auto","No","71038","314","494107","977","566436","0.43"
"2025-09-08T20:50:49.741Z","Included","auto","No","128186","370","978865","3025","1110446","0.82"
"2025-09-08T20:23:32.760Z","Included","auto","No","94","170","70217","162","70643","0.02"
"2025-09-08T20:22:07.723Z","Included","auto","No","10995","367","387595","1464","400421","0.18"
"2025-09-08T20:20:02.498Z","Errored, Not Charged","auto","No","20778","209","784665","4189","809841","0.38"
"2025-09-08T20:19:50.296Z","Included","auto","No","27522","162","10922","219","38825","0.11"
"2025-09-08T19:55:02.899Z","Included","auto","No","6348","365","139573","1616","147902","0.09"
"2025-09-08T19:54:13.891Z","Errored, Not Charged","auto","No","380","389","31491","2408","34668","0.05"
"2025-09-08T19:39:32.838Z","Included","auto","No","20682","168","358109","2289","381248","0.22"
"2025-09-08T19:36:36.519Z","Included","auto","No","710","155","51158","227","52250","0.02"
"2025-09-08T19:30:46.250Z","Included","auto","No","14485","131927","172180","7174","325766","0.18"
"2025-09-08T19:19:32.492Z","Included","auto","No","50113","316","359213","1396","411038","0.32"
"2025-09-08T19:19:13.013Z","Errored, Not Charged","auto","No","2045","165","220703","503","223416","0.08"
"2025-09-08T19:17:24.251Z","Errored, Not Charged","auto","No","43831","90785","226498","9659","370773","0.29"
"2025-09-08T19:15:50.628Z","Errored, Not Charged","auto","No","6763","375","1864582","2145","1873865","0.62"
"2025-09-08T19:14:09.710Z","Errored, Not Charged","auto","No","7854","130","1919246","3230","1930460","0.65"
"2025-09-08T19:11:03.741Z","Errored, Not Charged","auto","No","132817","112","578994","1579","713502","0.70"
"2025-09-08T11:21:23.190Z","Included","auto","No","536","121","139485","143","140285","0.05"
"2025-09-08T11:19:26.331Z","Included","auto","No","3549","121","411581","3383","418634","0.19"
"2025-09-08T11:18:22.489Z","Included","auto","No","125014","393","145981","550","271938","0.52"
"2025-09-08T11:05:46.139Z","Errored, Not Charged","auto","No","10799","184","1279877","6502","1297362","0.52"
"2025-09-08T11:02:27.028Z","Included","auto","No","112844","425","499766","3400","616435","0.63"
"2025-09-08T10:48:49.767Z","Included","auto","No","1452","110","236181","673","238416","0.09"
"2025-09-08T10:47:02.927Z","Included","auto","No","9802","107","681536","4147","695592","0.30"
"2025-09-08T10:46:09.775Z","Included","auto","No","2014","115","212516","360","215005","0.08"
"2025-09-08T10:43:38.602Z","Included","auto","No","3015","109","522271","1071","526466","0.18"
"2025-09-08T10:34:08.191Z","Included","auto","No","1512","147","408315","713","410687","0.14"
"2025-09-08T10:32:26.014Z","Included","auto","No","90606","205","487788","3639","582238","0.54"
"2025-09-08T10:25:34.164Z","Errored, Not Charged","auto","No","5130","162","348292","4471","358055","0.19"
"2025-09-08T10:22:38.697Z","Included","auto","No","3737","350","418615","1053","423755","0.16"
"2025-09-08T10:16:11.010Z","Included","auto","No","47081","310","704585","15986","767962","0.63"
"2025-09-08T10:14:48.599Z","Included","auto","No","16183","306","104344","5312","126145","0.17"
"2025-09-08T10:13:40.802Z","Errored, Not Charged","auto","No","7599","14","41718","4767","54098","0.11"
"2025-09-08T10:07:05.906Z","Included","auto","No","5873","208","1247618","3812","1257511","0.45"
"2025-09-08T09:58:38.297Z","Included","auto","No","24700","390","2002471","12389","2039950","0.88"
"2025-09-08T09:57:12.475Z","Included","auto","No","4960","175","663277","2748","671160","0.26"
"2025-09-08T09:56:14.571Z","Errored, Not Charged","auto","No","1842","173","141151","282","143448","0.05"
"2025-09-08T09:54:50.522Z","Errored, Not Charged","auto","No","5207","164","664070","3034","672475","0.26"
"2025-09-08T09:52:55.106Z","Included","auto","No","8196","3188","548693","4269","564346","0.27"
"2025-09-08T09:48:27.640Z","Errored, Not Charged","auto","No","15951","3178","392896","2444","414469","0.22"
"2025-09-08T09:44:20.870Z","Included","auto","No","29593","118438","344089","6663","498783","0.30"
"2025-09-08T09:41:07.326Z","Included","auto","No","9180","3104","2030282","3045","2045611","0.70"
"2025-09-08T09:38:03.075Z","Included","auto","No","18329","3236","555200","1534","578299","0.27"
"2025-09-08T09:36:54.853Z","Included","auto","No","122142","3259","405395","719","531515","0.60"
"2025-09-08T09:25:40.119Z","Included","auto","No","9306","3245","615999","2041","630591","0.26"
"2025-09-08T09:23:33.100Z","Included","auto","No","13971","3238","1011907","4718","1033834","0.44"
"2025-09-08T09:18:57.205Z","Included","auto","No","5054","3101","618991","1539","628685","0.24"
"2025-09-08T09:17:42.575Z","Included","auto","No","4513","3090","292005","669","300277","0.12"
"2025-09-08T09:14:53.455Z","Included","auto","No","84963","469","1065050","6531","1157013","0.74"
"2025-09-08T09:00:30.796Z","Included","auto","No","72253","32","2704186","12893","2789364","1.28"
"2025-09-08T08:59:08.271Z","Included","auto","No","3906","164","672886","2287","679243","0.25"
"2025-09-08T08:56:00.423Z","Included","auto","No","7470","187","768849","3536","780042","0.31"
"2025-09-08T08:55:51.357Z","Errored, Not Charged","auto","No","114455","164","10922","117","125658","0.43"
"2025-09-08T07:40:13.082Z","Included","auto","No","113911","167","10922","281","125281","0.44"
"2025-09-08T05:59:26.199Z","Included","auto","No","17344","173","2077421","7617","2102555","0.80"
"2025-09-08T05:58:30.634Z","Included","auto","No","706","194","212616","811","214327","0.08"
"2025-09-08T05:56:47.198Z","Errored, Not Charged","auto","No","3283","165","412264","2638","418350","0.18"
"2025-09-08T05:53:13.822Z","Included","auto","No","765","188","202863","499","204315","0.07"
"2025-09-08T05:49:51.561Z","Included","auto","No","880","195","201146","421","202642","0.07"
"2025-09-08T05:46:34.655Z","Errored, Not Charged","auto","No","8560","212","761700","1746","772218","0.29"
"2025-09-08T05:44:57.805Z","Included","auto","No","4010","330","448384","1858","454582","0.18"
"2025-09-08T05:37:50.880Z","Included","auto","No","14921","167","1618199","5524","1638811","0.62"
"2025-09-08T05:30:50.139Z","Included","auto","No","61978","96044","955815","17961","1131798","0.74"
"2025-09-08T05:24:29.904Z","Included","auto","No","7994","189","928833","1061","938077","0.33"
"2025-09-08T05:20:24.179Z","Included","auto","No","3288","204","902882","2322","908696","0.32"
"2025-09-08T05:16:00.595Z","Included","auto","No","20793","287","2644184","3632","2668896","0.93"
"2025-09-08T05:14:34.968Z","Included","auto","No","117346","128","266235","594","384303","0.53"
"2025-09-08T05:04:20.778Z","Errored, Not Charged","auto","No","115981","108","10922","172","127183","0.44"
"2025-09-08T04:58:09.992Z","Included","auto","No","531","145","125679","545","126900","0.05"
"2025-09-08T04:52:49.674Z","Included","auto","No","114757","157","1163360","3414","1281688","0.83"
"2025-09-08T04:34:14.573Z","Included","auto","No","14049","159","810634","1870","826712","0.32"
"2025-09-08T04:29:41.644Z","Included","auto","No","13737","276","886238","6718","906969","0.42"
"2025-09-08T04:18:40.074Z","Included","auto","No","70696","51","1010134","8476","1089357","0.70"
"2025-09-08T03:56:14.027Z","Included","auto","No","47816","145","135832","23977","207770","0.58"
"2025-09-08T03:36:31.610Z","Included","auto","No","23232","79002","261114","8553","371901","0.24"
"2025-09-08T03:34:22.492Z","Errored, Not Charged","auto","No","5478","108","1085987","3577","1095150","0.40"
"2025-09-08T03:16:24.781Z","Included","auto","No","42498","978","2816071","25237","2884784","1.39"
"2025-09-08T03:08:32.523Z","Errored, Not Charged","auto","No","17750","452","2184997","11169","2214368","0.89"
"2025-09-08T02:54:51.441Z","Errored, Not Charged","auto","No","52411","155","3498008","25277","3575851","1.63"
"2025-09-08T02:50:01.747Z","Included","auto","No","14607","123","481832","5774","502336","0.29"
"2025-09-08T02:47:05.493Z","Included","auto","No","14093","68142","85410","8465","176110","0.13"
"2025-09-08T02:42:57.698Z","Included","auto","No","7529","334","1451063","2435","1461361","0.50"
"2025-09-08T02:37:14.781Z","Errored, Not Charged","auto","No","11560","3972","1513880","4565","1533977","0.58"
"2025-09-08T02:24:15.291Z","Included","auto","No","19365","151","2423952","14635","2458103","1.02"
"2025-09-08T02:15:51.382Z","Included","auto","No","28555","109","1799389","22765","1850818","0.99"
"2025-09-08T02:06:27.695Z","Included","auto","No","24585","107","1411639","22070","1458401","0.85"
"2025-09-08T02:05:30.324Z","Included","auto","No","4784","134","135542","985","141445","0.07"
"2025-09-08T02:04:11.329Z","Included","auto","No","56174","153","73700","970","130997","0.25"
"2025-09-07T19:29:28.334Z","Included","auto","No","568","114","61441","375","62498","0.03"
"2025-09-07T19:25:17.512Z","Included","auto","No","50242","109","11199","456","62006","0.20"
"2025-09-07T19:18:09.979Z","Included","auto","No","49895","174","71062","496","121627","0.22"
"2025-09-07T18:59:58.911Z","Included","auto","No","692","171","117240","695","118798","0.05"
"2025-09-07T18:57:21.904Z","Included","auto","No","7965","3522","429861","5806","447154","0.25"
"2025-09-07T18:55:38.629Z","Errored, Not Charged","auto","No","39456","190","209336","891","249873","0.22"
"2025-09-07T18:43:02.336Z","Included","auto","No","332","181","47966","463","48942","0.02"
"2025-09-07T18:42:04.646Z","Included","auto","No","36767","188","246080","1081","284116","0.23"
"2025-09-07T18:31:56.661Z","Included","auto","No","7104","336","340116","2626","350182","0.17"
"2025-09-07T18:26:32.664Z","Included","auto","No","27370","123740","429293","8362","588765","0.33"
"2025-09-07T18:18:56.494Z","Included","auto","No","13287","623","1819975","10097","1843982","0.75"
"2025-09-07T18:17:53.059Z","Errored, Not Charged","auto","No","2637","662","464925","1645","469869","0.18"
"2025-09-07T18:13:59.223Z","Included","auto","No","6335","726","1058892","2740","1068693","0.38"
"2025-09-07T18:04:04.183Z","Included","auto","No","136754","727","3301867","14414","3453762","1.72"
"2025-09-07T17:38:36.184Z","Included","auto","No","139423","697","2968817","10708","3119645","1.58"
"2025-09-07T17:33:27.034Z","Included","auto","No","26719","132351","243507","5165","407742","0.24"
"2025-09-07T17:24:44.416Z","Included","auto","No","159031","602","2114068","3185","2276886","1.28"
"2025-09-07T17:06:13.285Z","Included","auto","No","170404","29","7491033","12151","7673617","3.07"
"2025-09-07T16:37:15.433Z","Included","auto","No","304821","123918","13720868","50500","14200107","6.00"
"2025-09-07T10:15:03.363Z","Included","auto","No","3979","1055","766224","650","771908","0.26"
"2025-09-07T10:09:02.425Z","Included","auto","No","22992","118","2255925","2705","2281740","0.80"
"2025-09-07T10:08:33.536Z","Errored, Not Charged","auto","No","2432","106","379485","1190","383213","0.14"
"2025-09-07T10:07:05.078Z","Included","auto","No","335","111","125473","296","126215","0.04"
"2025-09-07T10:04:33.662Z","Included","auto","No","2487","115","743000","1068","746670","0.25"
"2025-09-07T10:03:44.641Z","Included","auto","No","956","158","367012","470","368596","0.12"
"2025-09-07T10:02:52.565Z","Included","auto","No","1398","163","363134","491","365186","0.12"
"2025-09-07T10:02:20.227Z","Errored, Not Charged","auto","No","1048","162","358674","365","360249","0.12"
"2025-09-07T10:01:12.155Z","Included","auto","No","107981","117","365664","635","474397","0.52"
"2025-09-07T09:48:05.979Z","Errored, Not Charged","auto","No","6126","4569","456012","917","467624","0.19"
"2025-09-07T09:35:42.539Z","Errored, Not Charged","auto","No","128997","4402","3385918","24161","3543478","1.88"
"2025-09-07T09:24:08.725Z","Included","auto","No","167427","204","5281076","14720","5463427","2.43"
"2025-09-07T09:24:04.910Z","Errored, Not Charged","auto","No","0","0","0","0","0","0.00"
"2025-09-07T09:10:29.820Z","Errored, Not Charged","auto","No","93866","226778","3454692","14517","3789853","1.59"
"2025-09-07T09:01:17.691Z","Errored, Not Charged","auto","No","78825","102300","2366639","25919","2573683","1.34"
"2025-09-07T08:58:08.658Z","Errored, Not Charged","auto","No","138771","22890","604686","6466","772813","0.75"
"2025-09-07T08:41:21.565Z","Included","auto","No","151539","33","8513060","34908","8699540","3.65"
"2025-09-07T08:35:32.332Z","Included","auto","No","53848","154","4219081","11928","4285011","1.65"
"2025-09-07T08:30:00.385Z","Errored, Not Charged","auto","No","95328","186","3059037","5102","3159653","1.35"
"2025-09-07T08:28:45.824Z","Included","auto","No","10019","163","699449","2273","711904","0.28"
"2025-09-07T08:22:15.393Z","Included","auto","No","61270","168","1651909","7877","1721224","0.84"
"2025-09-07T08:20:26.030Z","Included","auto","No","3654","287","110319","1472","115732","0.07"
"2025-09-07T08:18:27.569Z","Included","auto","No","5755","22","87426","1504","94707","0.07"
"2025-09-07T08:15:00.809Z","Included","auto","No","10357","187","469702","4179","484425","0.24"
"2025-09-07T08:06:39.342Z","Included","auto","No","14526","467","844578","12654","872225","0.50"
"2025-09-07T08:01:52.525Z","Errored, Not Charged","auto","No","86684","434","1038894","6444","1132456","0.73"
"2025-09-07T06:06:07.098Z","Included","auto","No","189848","84206","4831042","35076","5140172","2.61"
"2025-09-07T05:59:51.896Z","Errored, Not Charged","auto","No","115914","114","471283","21457","608768","0.90"
"2025-09-07T05:45:39.871Z","Included","auto","No","98831","508","320328","1618","421285","0.49"
"2025-09-07T04:34:35.765Z","Included","auto","No","87006","173","4132840","10086","4230105","1.72"
"2025-09-06T21:31:14.127Z","Included","auto","No","925","238","149904","598","151665","0.06"
"2025-09-06T21:29:44.060Z","Included","auto","No","1075","205","97865","288","99433","0.04"
"2025-09-06T21:24:05.887Z","Included","auto","No","13439","233","970804","5062","989538","0.42"
"2025-09-06T21:20:35.144Z","Included","auto","No","24000","99969","146915","7552","278436","0.19"
"2025-09-06T21:18:57.602Z","Included","auto","No","12096","202","2096187","2191","2110676","0.71"
"2025-09-06T21:18:01.466Z","Included","auto","No","2569","212","1078274","1185","1082240","0.35"
"2025-09-06T21:14:02.096Z","Included","auto","No","24086","173","2391686","2968","2418913","0.85"
"2025-09-06T21:13:03.059Z","Included","auto","No","1535","181","639219","889","641824","0.21"
"2025-09-06T21:12:46.858Z","Errored, Not Charged","auto","No","1299","247","252499","264","254309","0.09"
"2025-09-06T21:11:35.397Z","Included","auto","No","114675","444","1008709","1481","1125309","0.76"
"2025-09-06T13:19:02.035Z","Included","auto","No","123888","48830","2398501","16924","2588143","1.40"
"2025-09-06T12:56:04.873Z","Included","auto","No","216708","475","6322353","27800","6567336","3.13"
"2025-09-06T12:53:20.627Z","Included","auto","No","4639","491","723176","2192","730498","0.27"
"2025-09-06T12:42:50.016Z","Included","auto","No","360771","391664","4053131","26577","4832143","2.96"
"2025-09-06T12:25:49.004Z","Included","auto","No","152792","36","7832976","24818","8010622","3.30"
"2025-09-06T12:20:08.300Z","Errored, Not Charged","auto","No","42741","180","5506992","9602","5559515","1.96"
"2025-09-06T12:12:12.087Z","Included","auto","No","139208","66955","5054656","14958","5275777","2.22"
"2025-09-06T12:08:22.825Z","Included","auto","No","28014","125","1594130","4283","1626552","0.65"
"2025-09-06T11:53:06.373Z","Errored, Not Charged","auto","No","118478","102433","6957494","38262","7216667","3.08"
"2025-09-06T11:52:11.103Z","Included","auto","No","1203","168","445088","888","447347","0.15"
"2025-09-06T11:51:50.679Z","Included","auto","No","136937","196","158908","287","296328","0.57"
"2025-09-06T11:45:47.254Z","Included","auto","No","3640","202","871441","1553","876836","0.30"
"2025-09-06T11:44:06.851Z","Included","auto","No","12405","298","1658650","3394","1674747","0.60"
"2025-09-06T11:41:47.926Z","Included","auto","No","8359","170","2271077","2854","2282460","0.76"
"2025-09-06T11:41:06.862Z","Included","auto","No","2193","198","486265","972","489628","0.17"
"2025-09-06T11:39:50.285Z","Included","auto","No","3491","186","832232","1495","837404","0.29"
"2025-09-06T11:38:34.947Z","Included","auto","No","4287","429","805561","1853","812130","0.29"
"2025-09-06T11:35:41.721Z","Included","auto","No","4343","168","664077","2201","670789","0.25"
"2025-09-06T11:34:06.465Z","Included","auto","No","2085","203","537541","1015","540844","0.18"
"2025-09-06T11:30:34.648Z","Included","auto","No","15226","169","2558789","4943","2579127","0.90"
"2025-09-06T11:27:49.301Z","Errored, Not Charged","auto","No","20853","279","1762471","4421","1788024","0.67"
"2025-09-06T11:20:28.421Z","Included","auto","No","97906","210","4346091","17779","4461986","1.94"
"2025-09-06T11:19:58.353Z","Included","auto","No","121889","516","142935","686","266026","0.51"
"2025-09-06T11:10:31.692Z","Included","auto","No","119996","51","3579709","28506","3728262","1.95"
"2025-09-06T03:47:37.930Z","Included","auto","No","11063","348","31776","569","43756","0.06"
"2025-09-06T01:42:02.556Z","Included","auto","No","169894","130522","4121709","24363","4446488","2.19"
"2025-09-06T01:30:06.177Z","Included","auto","No","138132","106382","4340402","19606","4604522","2.07"
"2025-09-06T01:23:56.825Z","Included","auto","No","7375","192","1596143","3740","1607450","0.56"
"2025-09-06T01:19:58.821Z","Included","auto","No","129658","189","2700477","4065","2834389","1.36"
"2025-09-05T18:39:02.733Z","Included","auto","No","104554","316","1239932","4988","1349790","0.84"
"2025-09-05T17:45:25.058Z","Included","auto","No","117760","76158","7095262","20418","7309598","2.77"
"2025-09-05T17:43:26.684Z","Included","auto","No","132561","275","605962","1429","740227","0.70"
"2025-09-05T17:25:46.990Z","Included","auto","No","1578","227","316703","709","319217","0.11"
"2025-09-05T17:19:13.130Z","Included","auto","No","13433","224","1196653","5445","1215755","0.49"
"2025-09-05T17:10:04.571Z","Included","auto","No","392397","22604","4125951","22512","4563464","2.96"
"2025-09-05T16:41:00.307Z","Included","auto","No","328095","316","6782956","16789","7128156","3.52"
"2025-09-05T16:27:31.453Z","Included","auto","No","594720","80070","9145079","27216","9847085","5.33"
"2025-09-05T16:25:39.975Z","Included","auto","No","31795","164","512883","1137","545979","0.29"
"2025-09-05T16:19:31.776Z","Included","auto","No","22843","189","887809","6567","917408","0.45"
"2025-09-05T16:15:11.872Z","Included","auto","No","16281","172","1650706","13544","1680703","0.76"
"2025-09-05T16:11:37.905Z","Errored, Not Charged","auto","No","106924","106604","914595","12220","1140343","0.82"
"2025-09-05T16:09:27.956Z","Included","auto","No","27597","192","563834","804","592427","0.29"
"2025-09-05T16:06:00.622Z","Included","auto","No","20170","335","1768590","6877","1795972","0.71"
"2025-09-05T15:58:14.365Z","Included","auto","No","177259","191","5418797","9490","5605737","2.43"
"2025-09-05T15:50:43.900Z","Included","auto","No","230810","175","5535015","9381","5775381","2.67"
"2025-09-05T15:37:02.534Z","Included","auto","No","86998","157","3932027","13892","4033074","1.71"
"2025-09-05T15:35:11.371Z","Errored, Not Charged","auto","No","4515","111","314599","1808","321033","0.14"
"2025-09-05T15:34:31.249Z","Included","auto","No","108","118","22363","142","22731","0.01"
"2025-09-05T15:32:55.499Z","Included","auto","No","11685","176","53686","371","65918","0.07"
"2025-09-05T15:26:42.240Z","Errored, Not Charged","auto","No","10250","238586","91670","5966","346472","0.13"
"2025-09-05T15:15:29.729Z","Included","auto","No","663","172","268024","327","269186","0.09"
"2025-09-05T15:13:02.077Z","Errored, Not Charged","auto","No","4731","160","1843979","2077","1850947","0.60"
"2025-09-05T15:11:15.158Z","Errored, Not Charged","auto","No","2893","160","891566","1251","895870","0.30"
"2025-09-05T15:10:23.873Z","Errored, Not Charged","auto","No","5186","346","623304","718","629554","0.22"
"2025-09-05T15:00:31.322Z","Errored, Not Charged","auto","No","11580","176","3691599","4990","3708345","1.23"
"2025-09-05T14:58:29.239Z","Errored, Not Charged","auto","No","98827","57980","769361","5220","931388","0.64"
"2025-09-05T14:46:54.690Z","Included","auto","No","88612","247","11030982","22152","11141993","3.97"
"2025-09-05T14:43:33.248Z","Included","auto","No","70481","95362","933450","10830","1110123","0.65"
"2025-09-05T14:34:13.943Z","Included","auto","No","47659","172","4731172","9412","4788415","1.74"
"2025-09-05T14:23:32.107Z","Included","auto","No","112348","29","6376304","22222","6510903","2.67"
"2025-09-05T05:33:23.511Z","Included","auto","No","46899","151","2040781","8518","2096349","0.92"
"2025-09-05T05:26:42.830Z","Included","auto","No","31120","10720","364734","10341","416915","0.30"
"2025-09-05T05:07:15.704Z","Included","auto","No","178919","112440","8683631","31045","9006035","3.68"
"2025-09-05T05:05:39.449Z","Included","auto","No","2593","193","1067718","1244","1071748","0.35"
"2025-09-05T05:02:27.462Z","Included","auto","No","8263","249","1328265","5117","1341894","0.51"
"2025-09-05T04:48:50.887Z","Included","auto","No","68889","1635","7301549","19460","7391533","2.74"
"2025-09-05T04:40:51.438Z","Included","auto","No","148162","174","6183836","7965","6340137","2.53"
"2025-09-05T04:33:16.881Z","Included","auto","No","135279","47941","3383818","10517","3577555","1.63"
"2025-09-05T04:21:49.621Z","Included","auto","No","82228","662","7531262","17951","7632103","2.84"
"2025-09-05T04:14:58.501Z","Errored, Not Charged","auto","No","62886","79942","1532125","24478","1699431","0.98"
"2025-09-05T04:13:40.008Z","Errored, Not Charged","auto","No","10872","150","1592470","1834","1605326","0.55"
"2025-09-05T04:11:20.067Z","Included","auto","No","1161","6575","150489","472","158697","0.08"
"2025-09-05T04:02:45.222Z","Included","auto","No","139290","121","4214982","18896","4373289","2.07"
"2025-09-05T03:14:28.924Z","Included","auto","No","96425","31455","2826742","35464","2990086","1.65"
"2025-09-05T03:07:27.401Z","Errored, Not Charged","auto","No","27293","611","1498690","25676","1552270","0.94"
"2025-09-05T02:51:32.091Z","Included","auto","No","125840","14468","4456838","42561","4639707","2.41"
"2025-09-05T02:37:20.891Z","Included","auto","No","46626","589","3553836","41952","3643003","1.87"
"2025-09-05T02:24:03.015Z","Errored, Not Charged","auto","No","181197","32488","1941342","51889","2206916","2.00"
"2025-09-05T02:10:21.063Z","Included","auto","No","133527","840","2371831","32794","2538992","1.71"
"2025-09-05T01:59:29.083Z","Included","auto","No","30597","701","1694472","16300","1742070","0.87"
"2025-09-05T01:51:56.517Z","Included","auto","No","27403","312","1203846","18246","1249807","0.74"
"2025-09-05T01:51:04.485Z","Errored, Not Charged","auto","No","1978","306","199039","3139","204462","0.12"
"2025-09-05T01:42:19.756Z","Errored, Not Charged","auto","No","37228","12","1027790","33743","1098773","0.95"
"2025-09-05T01:37:37.745Z","Included","auto","No","1248","10","35371","759","37388","0.03"
"2025-09-05T01:35:41.960Z","Errored, Not Charged","auto","No","374","0","7129","319","7822","0.003"
"2025-08-30T23:11:10.270Z","Included","auto","No","120389","89458","1083351","11158","1304356","0.45"
"2025-08-30T22:34:41.483Z","Included","auto","No","90717","0","188667","627","280011","0.14"
"2025-08-27T17:51:15.774Z","Included","auto","No","87447","0","250718","1298","339463","0.16"
